total_rows,rows_updated,rows_created,errors,date,day_of_week,axis_label
31814,3210,28604,12,2024-02-23,Friday,Friday 2024-02-23
32641,7499,25142,28,2024-02-22,Thursday,Thursday 2024-02-22
27080,17965,9115,5,2024-02-21,Wednesday,Wednesday 2024-02-21
33074,2722,30352,8,2024-02-20,Tuesday,Tuesday 2024-02-20
2092,53,2039,11,2024-02-19,Monday,Monday 2024-02-19
2089,2027,62,19,2024-02-18,Sunday,Sunday 2024-02-18
30109,4161,25948,15,2024-02-17,Saturday,Saturday 2024-02-17
25859,8569,17290,16,2024-02-16,Friday,Friday 2024-02-16
33632,13424,20208,20,2024-02-15,Thursday,Thursday 2024-02-15
33925,21064,12861,9,2024-02-14,Wednesday,Wednesday 2024-02-14
31165,24512,6653,28,2024-02-13,Tuesday,Tuesday 2024-02-13
1986,1790,196,19,2024-02-12,Monday,Monday 2024-02-12
1842,1284,558,22,2024-02-11,Sunday,Sunday 2024-02-11
31608,1583,30025,13,2024-02-10,Saturday,Saturday 2024-02-10
35162,25093,10069,7,2024-02-09,Friday,Friday 2024-02-09
27729,8958,18771,9,2024-02-08,Thursday,Thursday 2024-02-08
27853,965,26888,12,2024-02-07,Wednesday,Wednesday 2024-02-07
27094,23674,3420,10,2024-02-06,Tuesday,Tuesday 2024-02-06
2064,1923,141,22,2024-02-05,Monday,Monday 2024-02-05
2277,1215,1062,9,2024-02-04,Sunday,Sunday 2024-02-04
30886,5119,25767,10,2024-02-03,Saturday,Saturday 2024-02-03
31928,16407,15521,24,2024-02-02,Friday,Friday 2024-02-02
29720,23815,5905,14,2024-02-01,Thursday,Thursday 2024-02-01
23156,8245,14911,11,2024-01-31,Wednesday,Wednesday 2024-01-31
29200,14682,14518,13,2024-01-30,Tuesday,Tuesday 2024-01-30
1519,161,1358,14,2024-01-29,Monday,Monday 2024-01-29
2099,1530,569,21,2024-01-28,Sunday,Sunday 2024-01-28
25870,10436,15434,28,2024-01-27,Saturday,Saturday 2024-01-27
25621,20856,4765,5,2024-01-26,Friday,Friday 2024-01-26
28184,12088,16096,16,2024-01-25,Thursday,Thursday 2024-01-25
33078,23930,9148,22,2024-01-24,Wednesday,Wednesday 2024-01-24
30056,4805,25251,16,2024-01-23,Tuesday,Tuesday 2024-01-23
1987,1857,130,29,2024-01-22,Monday,Monday 2024-01-22
1693,1059,634,17,2024-01-21,Sunday,Sunday 2024-01-21
29643,19857,9786,17,2024-01-20,Saturday,Saturday 2024-01-20
35702,23872,11830,8,2024-01-19,Friday,Friday 2024-01-19
30843,9139,21704,14,2024-01-18,Thursday,Thursday 2024-01-18
32250,15896,16354,10,2024-01-17,Wednesday,Wednesday 2024-01-17
25436,398,25038,11,2024-01-16,Tuesday,Tuesday 2024-01-16
2218,1444,774,12,2024-01-15,Monday,Monday 2024-01-15
1704,538,1166,19,2024-01-14,Sunday,Sunday 2024-01-14
31555,8152,23403,8,2024-01-13,Saturday,Saturday 2024-01-13
31510,9901,21609,9,2024-01-12,Friday,Friday 2024-01-12
29321,974,28347,9,2024-01-11,Thursday,Thursday 2024-01-11
27458,18412,9046,7,2024-01-10,Wednesday,Wednesday 2024-01-10
32625,28080,4545,23,2024-01-09,Tuesday,Tuesday 2024-01-09
1711,858,853,30,2024-01-08,Monday,Monday 2024-01-08
1354,904,450,14,2024-01-07,Sunday,Sunday 2024-01-07
31415,21737,9678,9,2024-01-06,Saturday,Saturday 2024-01-06
34977,22271,12706,17,2024-01-05,Friday,Friday 2024-01-05
27571,9813,17758,13,2024-01-04,Thursday,Thursday 2024-01-04
33316,17577,15739,8,2024-01-03,Wednesday,Wednesday 2024-01-03
33676,15179,18497,21,2024-01-02,Tuesday,Tuesday 2024-01-02
1485,919,566,19,2024-01-01,Monday,Monday 2024-01-01
1709,691,1018,24,2023-12-31,Sunday,Sunday 2023-12-31
32046,18195,13851,8,2023-12-30,Saturday,Saturday 2023-12-30
31434,8070,23364,19,2023-12-29,Friday,Friday 2023-12-29
27413,5080,22333,19,2023-12-28,Thursday,Thursday 2023-12-28
31371,29278,2093,15,2023-12-27,Wednesday,Wednesday 2023-12-27
29729,1990,27739,9,2023-12-26,Tuesday,Tuesday 2023-12-26
2128,604,1524,34,2023-12-25,Monday,Monday 2023-12-25
1882,1645,237,43,2023-12-24,Sunday,Sunday 2023-12-24
33878,3674,30204,5,2023-12-23,Saturday,Saturday 2023-12-23
29353,16618,12735,9,2023-12-22,Friday,Friday 2023-12-22
32046,3953,28093,17,2023-12-21,Thursday,Thursday 2023-12-21
27587,26493,1094,4,2023-12-20,Wednesday,Wednesday 2023-12-20
29502,17294,12208,12,2023-12-19,Tuesday,Tuesday 2023-12-19
1506,203,1303,32,2023-12-18,Monday,Monday 2023-12-18
2094,792,1302,9,2023-12-17,Sunday,Sunday 2023-12-17
31799,1848,29951,10,2023-12-16,Saturday,Saturday 2023-12-16
27662,12577,15085,17,2023-12-15,Friday,Friday 2023-12-15
29837,2272,27565,8,2023-12-14,Thursday,Thursday 2023-12-14
31777,9571,22206,10,2023-12-13,Wednesday,Wednesday 2023-12-13
29781,18845,10936,22,2023-12-12,Tuesday,Tuesday 2023-12-12
1743,85,1658,17,2023-12-11,Monday,Monday 2023-12-11
1708,1486,222,29,2023-12-10,Sunday,Sunday 2023-12-10
29659,23426,6233,17,2023-12-09,Saturday,Saturday 2023-12-09
37400,31132,6268,9,2023-12-08,Friday,Friday 2023-12-08
29531,26570,2961,5,2023-12-07,Thursday,Thursday 2023-12-07
35519,7273,28246,19,2023-12-06,Wednesday,Wednesday 2023-12-06
34191,4112,30079,5,2023-12-05,Tuesday,Tuesday 2023-12-05
1977,1350,627,21,2023-12-04,Monday,Monday 2023-12-04
1884,1180,704,29,2023-12-03,Sunday,Sunday 2023-12-03
25734,6065,19669,19,2023-12-02,Saturday,Saturday 2023-12-02
25236,15116,10120,13,2023-12-01,Friday,Friday 2023-12-01
30118,18974,11144,8,2023-11-30,Thursday,Thursday 2023-11-30
29691,18957,10734,22,2023-11-29,Wednesday,Wednesday 2023-11-29
27737,21789,5948,19,2023-11-28,Tuesday,Tuesday 2023-11-28
1753,492,1261,29,2023-11-27,Monday,Monday 2023-11-27
2103,1833,270,22,2023-11-26,Sunday,Sunday 2023-11-26
21794,18236,3558,5,2023-11-25,Saturday,Saturday 2023-11-25
27856,27828,28,10,2023-11-24,Friday,Friday 2023-11-24
27261,10297,16964,13,2023-11-23,Thursday,Thursday 2023-11-23
23834,20276,3558,14,2023-11-22,Wednesday,Wednesday 2023-11-22
39660,35594,4066,10,2023-11-21,Tuesday,Tuesday 2023-11-21
1730,1204,526,21,2023-11-20,Monday,Monday 2023-11-20
1735,63,1672,19,2023-11-19,Sunday,Sunday 2023-11-19
27782,23505,4277,10,2023-11-18,Saturday,Saturday 2023-11-18
29843,14689,15154,18,2023-11-17,Friday,Friday 2023-11-17
29201,18987,10214,18,2023-11-16,Thursday,Thursday 2023-11-16
29311,3206,26105,14,2023-11-15,Wednesday,Wednesday 2023-11-15
33351,22024,11327,10,2023-11-14,Tuesday,Tuesday 2023-11-14
1955,1946,9,9,2023-11-13,Monday,Monday 2023-11-13
1595,624,971,6,2023-11-12,Sunday,Sunday 2023-11-12
30019,16192,13827,14,2023-11-11,Saturday,Saturday 2023-11-11
31016,26866,4150,12,2023-11-10,Friday,Friday 2023-11-10
27953,22413,5540,9,2023-11-09,Thursday,Thursday 2023-11-09
33554,18737,14817,10,2023-11-08,Wednesday,Wednesday 2023-11-08
31884,20146,11738,11,2023-11-07,Tuesday,Tuesday 2023-11-07
2108,1135,973,21,2023-11-06,Monday,Monday 2023-11-06
1779,1205,574,27,2023-11-05,Sunday,Sunday 2023-11-05
37533,17109,20424,15,2023-11-04,Saturday,Saturday 2023-11-04
29141,5555,23586,19,2023-11-03,Friday,Friday 2023-11-03
32347,17364,14983,10,2023-11-02,Thursday,Thursday 2023-11-02
22237,5944,16293,24,2023-11-01,Wednesday,Wednesday 2023-11-01
29274,12388,16886,12,2023-10-31,Tuesday,Tuesday 2023-10-31
1680,977,703,34,2023-10-30,Monday,Monday 2023-10-30
1740,741,999,30,2023-10-29,Sunday,Sunday 2023-10-29
27649,21139,6510,9,2023-10-28,Saturday,Saturday 2023-10-28
27625,26636,989,17,2023-10-27,Friday,Friday 2023-10-27
29046,21350,7696,17,2023-10-26,Thursday,Thursday 2023-10-26
34869,24540,10329,8,2023-10-25,Wednesday,Wednesday 2023-10-25
33449,31807,1642,15,2023-10-24,Tuesday,Tuesday 2023-10-24
1240,469,771,32,2023-10-23,Monday,Monday 2023-10-23
1881,1586,295,17,2023-10-22,Sunday,Sunday 2023-10-22
27712,9815,17897,12,2023-10-21,Saturday,Saturday 2023-10-21
25307,7083,18224,17,2023-10-20,Friday,Friday 2023-10-20
36027,10539,25488,21,2023-10-19,Thursday,Thursday 2023-10-19
25214,6060,19154,16,2023-10-18,Wednesday,Wednesday 2023-10-18
22208,9282,12926,14,2023-10-17,Tuesday,Tuesday 2023-10-17
1759,686,1073,12,2023-10-16,Monday,Monday 2023-10-16
1558,161,1397,19,2023-10-15,Sunday,Sunday 2023-10-15
25843,7024,18819,5,2023-10-14,Saturday,Saturday 2023-10-14
27325,26049,1276,18,2023-10-13,Friday,Friday 2023-10-13
28171,11352,16819,16,2023-10-12,Thursday,Thursday 2023-10-12
26051,25512,539,12,2023-10-11,Wednesday,Wednesday 2023-10-11
25806,20204,5602,9,2023-10-10,Tuesday,Tuesday 2023-10-10
1941,870,1071,8,2023-10-09,Monday,Monday 2023-10-09
2206,914,1292,38,2023-10-08,Sunday,Sunday 2023-10-08
35376,24469,10907,17,2023-10-07,Saturday,Saturday 2023-10-07
23263,9712,13551,9,2023-10-06,Friday,Friday 2023-10-06
29605,10801,18804,18,2023-10-05,Thursday,Thursday 2023-10-05
29416,23123,6293,14,2023-10-04,Wednesday,Wednesday 2023-10-04
27984,9476,18508,9,2023-10-03,Tuesday,Tuesday 2023-10-03
1718,1352,366,25,2023-10-02,Monday,Monday 2023-10-02
1482,567,915,29,2023-10-01,Sunday,Sunday 2023-10-01
30140,1874,28266,7,2023-09-30,Saturday,Saturday 2023-09-30
30000,26853,3147,17,2023-09-29,Friday,Friday 2023-09-29
25073,9721,15352,20,2023-09-28,Thursday,Thursday 2023-09-28
23224,3871,19353,31,2023-09-27,Wednesday,Wednesday 2023-09-27
35610,27996,7614,4,2023-09-26,Tuesday,Tuesday 2023-09-26
2127,1607,520,43,2023-09-25,Monday,Monday 2023-09-25
1730,1239,491,16,2023-09-24,Sunday,Sunday 2023-09-24
27114,16315,10799,11,2023-09-23,Saturday,Saturday 2023-09-23
30116,28507,1609,5,2023-09-22,Friday,Friday 2023-09-22
13552,3572,9980,15,2023-09-21,Thursday,Thursday 2023-09-21
29931,1089,28842,22,2023-09-20,Wednesday,Wednesday 2023-09-20
29012,9347,19665,12,2023-09-19,Tuesday,Tuesday 2023-09-19
1740,591,1149,9,2023-09-18,Monday,Monday 2023-09-18
1734,199,1535,12,2023-09-17,Sunday,Sunday 2023-09-17
34905,11914,22991,11,2023-09-16,Saturday,Saturday 2023-09-16
31840,17447,14393,11,2023-09-15,Friday,Friday 2023-09-15
33332,21555,11777,11,2023-09-14,Thursday,Thursday 2023-09-14
29959,7064,22895,21,2023-09-13,Wednesday,Wednesday 2023-09-13
35972,32789,3183,23,2023-09-12,Tuesday,Tuesday 2023-09-12
2087,1413,674,16,2023-09-11,Monday,Monday 2023-09-11
1727,878,849,38,2023-09-10,Sunday,Sunday 2023-09-10
33809,18480,15329,9,2023-09-09,Saturday,Saturday 2023-09-09
33931,866,33065,11,2023-09-08,Friday,Friday 2023-09-08
31461,26201,5260,12,2023-09-07,Thursday,Thursday 2023-09-07
27429,8033,19396,12,2023-09-06,Wednesday,Wednesday 2023-09-06
31499,24627,6872,11,2023-09-05,Tuesday,Tuesday 2023-09-05
1570,1103,467,35,2023-09-04,Monday,Monday 2023-09-04
1719,288,1431,17,2023-09-03,Sunday,Sunday 2023-09-03
27837,918,26919,7,2023-09-02,Saturday,Saturday 2023-09-02
31698,23548,8150,14,2023-09-01,Friday,Friday 2023-09-01
27197,15278,11919,8,2023-08-31,Thursday,Thursday 2023-08-31
25353,258,25095,7,2023-08-30,Wednesday,Wednesday 2023-08-30
21358,8765,12593,16,2023-08-29,Tuesday,Tuesday 2023-08-29
1827,1097,730,14,2023-08-28,Monday,Monday 2023-08-28
2122,837,1285,30,2023-08-27,Sunday,Sunday 2023-08-27
30148,4219,25929,26,2023-08-26,Saturday,Saturday 2023-08-26
27698,11088,16610,11,2023-08-25,Friday,Friday 2023-08-25
30262,23639,6623,12,2023-08-24,Thursday,Thursday 2023-08-24
31243,25540,5703,20,2023-08-23,Wednesday,Wednesday 2023-08-23
31923,10008,21915,11,2023-08-22,Tuesday,Tuesday 2023-08-22
2149,2124,25,27,2023-08-21,Monday,Monday 2023-08-21
1873,596,1277,8,2023-08-20,Sunday,Sunday 2023-08-20
31436,14861,16575,12,2023-08-19,Saturday,Saturday 2023-08-19
30206,11218,18988,17,2023-08-18,Friday,Friday 2023-08-18
28070,4095,23975,18,2023-08-17,Thursday,Thursday 2023-08-17
31084,3553,27531,9,2023-08-16,Wednesday,Wednesday 2023-08-16
26807,21009,5798,16,2023-08-15,Tuesday,Tuesday 2023-08-15
2267,732,1535,24,2023-08-14,Monday,Monday 2023-08-14
1967,1580,387,14,2023-08-13,Sunday,Sunday 2023-08-13
36140,28702,7438,10,2023-08-12,Saturday,Saturday 2023-08-12
25908,6875,19033,13,2023-08-11,Friday,Friday 2023-08-11
25797,9127,16670,17,2023-08-10,Thursday,Thursday 2023-08-10
33268,31116,2152,10,2023-08-09,Wednesday,Wednesday 2023-08-09
31031,15386,15645,16,2023-08-08,Tuesday,Tuesday 2023-08-08
2018,526,1492,17,2023-08-07,Monday,Monday 2023-08-07
1690,1150,540,24,2023-08-06,Sunday,Sunday 2023-08-06
29284,6431,22853,10,2023-08-05,Saturday,Saturday 2023-08-05
35157,18680,16477,4,2023-08-04,Friday,Friday 2023-08-04
30030,12983,17047,12,2023-08-03,Thursday,Thursday 2023-08-03
25542,7184,18358,9,2023-08-02,Wednesday,Wednesday 2023-08-02
31630,30495,1135,7,2023-08-01,Tuesday,Tuesday 2023-08-01
1479,994,485,14,2023-07-31,Monday,Monday 2023-07-31
2089,766,1323,29,2023-07-30,Sunday,Sunday 2023-07-30
23285,3158,20127,11,2023-07-29,Saturday,Saturday 2023-07-29
24441,22627,1814,13,2023-07-28,Friday,Friday 2023-07-28
19988,5053,14935,15,2023-07-27,Thursday,Thursday 2023-07-27
29362,7169,22193,11,2023-07-26,Wednesday,Wednesday 2023-07-26
28072,305,27767,13,2023-07-25,Tuesday,Tuesday 2023-07-25
2078,454,1624,25,2023-07-24,Monday,Monday 2023-07-24
2171,337,1834,27,2023-07-23,Sunday,Sunday 2023-07-23
27921,10078,17843,14,2023-07-22,Saturday,Saturday 2023-07-22
23620,12149,11471,10,2023-07-21,Friday,Friday 2023-07-21
31621,7839,23782,9,2023-07-20,Thursday,Thursday 2023-07-20
27663,18677,8986,14,2023-07-19,Wednesday,Wednesday 2023-07-19
31747,15401,16346,23,2023-07-18,Tuesday,Tuesday 2023-07-18
1743,1450,293,22,2023-07-17,Monday,Monday 2023-07-17
1467,1200,267,17,2023-07-16,Sunday,Sunday 2023-07-16
29387,12433,16954,15,2023-07-15,Saturday,Saturday 2023-07-15
23930,21233,2697,19,2023-07-14,Friday,Friday 2023-07-14
28136,16285,11851,13,2023-07-13,Thursday,Thursday 2023-07-13
28088,5786,22302,14,2023-07-12,Wednesday,Wednesday 2023-07-12
25765,23483,2282,14,2023-07-11,Tuesday,Tuesday 2023-07-11
1743,636,1107,30,2023-07-10,Monday,Monday 2023-07-10
2218,2114,104,21,2023-07-09,Sunday,Sunday 2023-07-09
31086,15395,15691,13,2023-07-08,Saturday,Saturday 2023-07-08
32136,22488,9648,14,2023-07-07,Friday,Friday 2023-07-07
34255,26072,8183,9,2023-07-06,Thursday,Thursday 2023-07-06
29507,12854,16653,15,2023-07-05,Wednesday,Wednesday 2023-07-05
31578,6517,25061,22,2023-07-04,Tuesday,Tuesday 2023-07-04
2005,1760,245,32,2023-07-03,Monday,Monday 2023-07-03
2347,1734,613,12,2023-07-02,Sunday,Sunday 2023-07-02
28060,24449,3611,17,2023-07-01,Saturday,Saturday 2023-07-01
36041,3969,32072,15,2023-06-30,Friday,Friday 2023-06-30
23789,9693,14096,16,2023-06-29,Thursday,Thursday 2023-06-29
28932,10569,18363,12,2023-06-28,Wednesday,Wednesday 2023-06-28
31655,3930,27725,16,2023-06-27,Tuesday,Tuesday 2023-06-27
2095,524,1571,42,2023-06-26,Monday,Monday 2023-06-26
1728,1521,207,24,2023-06-25,Sunday,Sunday 2023-06-25
25399,10129,15270,17,2023-06-24,Saturday,Saturday 2023-06-24
29686,6141,23545,16,2023-06-23,Friday,Friday 2023-06-23
27933,8851,19082,13,2023-06-22,Thursday,Thursday 2023-06-22
35205,25833,9372,12,2023-06-21,Wednesday,Wednesday 2023-06-21
31234,6308,24926,8,2023-06-20,Tuesday,Tuesday 2023-06-20
1356,1166,190,34,2023-06-19,Monday,Monday 2023-06-19
2220,1648,572,30,2023-06-18,Sunday,Sunday 2023-06-18
22541,5049,17492,15,2023-06-17,Saturday,Saturday 2023-06-17
25278,1395,23883,27,2023-06-16,Friday,Friday 2023-06-16
26108,3099,23009,10,2023-06-15,Thursday,Thursday 2023-06-15
25031,24138,893,6,2023-06-14,Wednesday,Wednesday 2023-06-14
33785,13394,20391,14,2023-06-13,Tuesday,Tuesday 2023-06-13
1958,278,1680,8,2023-06-12,Monday,Monday 2023-06-12
1648,1390,258,21,2023-06-11,Sunday,Sunday 2023-06-11
30049,8878,21171,14,2023-06-10,Saturday,Saturday 2023-06-10
31189,1085,30104,15,2023-06-09,Friday,Friday 2023-06-09
31435,4076,27359,10,2023-06-08,Thursday,Thursday 2023-06-08
32685,30263,2422,24,2023-06-07,Wednesday,Wednesday 2023-06-07
31368,3802,27566,14,2023-06-06,Tuesday,Tuesday 2023-06-06
1552,820,732,48,2023-06-05,Monday,Monday 2023-06-05
1574,933,641,11,2023-06-04,Sunday,Sunday 2023-06-04
25687,5019,20668,25,2023-06-03,Saturday,Saturday 2023-06-03
25179,15745,9434,5,2023-06-02,Friday,Friday 2023-06-02
33162,27581,5581,25,2023-06-01,Thursday,Thursday 2023-06-01
29622,1733,27889,10,2023-05-31,Wednesday,Wednesday 2023-05-31
31032,9011,22021,10,2023-05-30,Tuesday,Tuesday 2023-05-30
2203,1991,212,12,2023-05-29,Monday,Monday 2023-05-29
1492,339,1153,25,2023-05-28,Sunday,Sunday 2023-05-28
33300,7499,25801,13,2023-05-27,Saturday,Saturday 2023-05-27
29339,3557,25782,19,2023-05-26,Friday,Friday 2023-05-26
32554,28585,3969,15,2023-05-25,Thursday,Thursday 2023-05-25
29262,2559,26703,18,2023-05-24,Wednesday,Wednesday 2023-05-24
34104,33882,222,14,2023-05-23,Tuesday,Tuesday 2023-05-23
1835,53,1782,22,2023-05-22,Monday,Monday 2023-05-22
2261,1449,812,40,2023-05-21,Sunday,Sunday 2023-05-21
31549,25767,5782,6,2023-05-20,Saturday,Saturday 2023-05-20
35220,26514,8706,19,2023-05-19,Friday,Friday 2023-05-19
24797,13085,11712,20,2023-05-18,Thursday,Thursday 2023-05-18
27305,8964,18341,19,2023-05-17,Wednesday,Wednesday 2023-05-17
33740,26826,6914,18,2023-05-16,Tuesday,Tuesday 2023-05-16
1512,715,797,29,2023-05-15,Monday,Monday 2023-05-15
1606,1251,355,16,2023-05-14,Sunday,Sunday 2023-05-14
32278,30505,1773,9,2023-05-13,Saturday,Saturday 2023-05-13
19582,17210,2372,15,2023-05-12,Friday,Friday 2023-05-12
28052,24739,3313,11,2023-05-11,Thursday,Thursday 2023-05-11
31485,23075,8410,13,2023-05-10,Wednesday,Wednesday 2023-05-10
21840,20480,1360,8,2023-05-09,Tuesday,Tuesday 2023-05-09
2054,1396,658,14,2023-05-08,Monday,Monday 2023-05-08
1828,1726,102,24,2023-05-07,Sunday,Sunday 2023-05-07
34104,12501,21603,17,2023-05-06,Saturday,Saturday 2023-05-06
25024,6338,18686,5,2023-05-05,Friday,Friday 2023-05-05
33025,32410,615,12,2023-05-04,Thursday,Thursday 2023-05-04
38216,15598,22618,13,2023-05-03,Wednesday,Wednesday 2023-05-03
29102,2516,26586,15,2023-05-02,Tuesday,Tuesday 2023-05-02
2199,961,1238,34,2023-05-01,Monday,Monday 2023-05-01
1877,382,1495,42,2023-04-30,Sunday,Sunday 2023-04-30
23472,17446,6026,12,2023-04-29,Saturday,Saturday 2023-04-29
25685,1692,23993,10,2023-04-28,Friday,Friday 2023-04-28
29802,8819,20983,14,2023-04-27,Thursday,Thursday 2023-04-27
21461,1434,20027,16,2023-04-26,Wednesday,Wednesday 2023-04-26
31148,482,30666,11,2023-04-25,Tuesday,Tuesday 2023-04-25
1682,1144,538,11,2023-04-24,Monday,Monday 2023-04-24
1728,671,1057,27,2023-04-23,Sunday,Sunday 2023-04-23
23910,6065,17845,10,2023-04-22,Saturday,Saturday 2023-04-22
26909,9535,17374,10,2023-04-21,Friday,Friday 2023-04-21
27329,14323,13006,14,2023-04-20,Thursday,Thursday 2023-04-20
25931,4188,21743,21,2023-04-19,Wednesday,Wednesday 2023-04-19
29019,16189,12830,13,2023-04-18,Tuesday,Tuesday 2023-04-18
1840,1242,598,22,2023-04-17,Monday,Monday 2023-04-17
1563,515,1048,12,2023-04-16,Sunday,Sunday 2023-04-16
37134,25860,11274,9,2023-04-15,Saturday,Saturday 2023-04-15
31744,1355,30389,13,2023-04-14,Friday,Friday 2023-04-14
25690,14063,11627,15,2023-04-13,Thursday,Thursday 2023-04-13
22042,6310,15732,9,2023-04-12,Wednesday,Wednesday 2023-04-12
25242,19713,5529,23,2023-04-11,Tuesday,Tuesday 2023-04-11
1757,1343,414,9,2023-04-10,Monday,Monday 2023-04-10
1734,457,1277,14,2023-04-09,Sunday,Sunday 2023-04-09
31653,78,31575,13,2023-04-08,Saturday,Saturday 2023-04-08
28367,7319,21048,29,2023-04-07,Friday,Friday 2023-04-07
26148,25971,177,25,2023-04-06,Thursday,Thursday 2023-04-06
25795,15274,10521,27,2023-04-05,Wednesday,Wednesday 2023-04-05
21474,2083,19391,12,2023-04-04,Tuesday,Tuesday 2023-04-04
1891,1518,373,16,2023-04-03,Monday,Monday 2023-04-03
1632,692,940,22,2023-04-02,Sunday,Sunday 2023-04-02
34148,9159,24989,7,2023-04-01,Saturday,Saturday 2023-04-01
27299,6828,20471,14,2023-03-31,Friday,Friday 2023-03-31
23864,3450,20414,13,2023-03-30,Thursday,Thursday 2023-03-30
17690,17280,410,12,2023-03-29,Wednesday,Wednesday 2023-03-29
32196,3722,28474,14,2023-03-28,Tuesday,Tuesday 2023-03-28
2098,775,1323,21,2023-03-27,Monday,Monday 2023-03-27
1579,272,1307,24,2023-03-26,Sunday,Sunday 2023-03-26
29898,14369,15529,9,2023-03-25,Saturday,Saturday 2023-03-25
23872,4760,19112,17,2023-03-24,Friday,Friday 2023-03-24
23953,13425,10528,19,2023-03-23,Thursday,Thursday 2023-03-23
33789,10597,23192,7,2023-03-22,Wednesday,Wednesday 2023-03-22
21122,1192,19930,4,2023-03-21,Tuesday,Tuesday 2023-03-21
1885,1855,30,8,2023-03-20,Monday,Monday 2023-03-20
1889,1227,662,29,2023-03-19,Sunday,Sunday 2023-03-19
34138,4137,30001,18,2023-03-18,Saturday,Saturday 2023-03-18
33814,25968,7846,12,2023-03-17,Friday,Friday 2023-03-17
27660,24329,3331,7,2023-03-16,Thursday,Thursday 2023-03-16
29388,7875,21513,10,2023-03-15,Wednesday,Wednesday 2023-03-15
23606,4041,19565,14,2023-03-14,Tuesday,Tuesday 2023-03-14
1474,1189,285,14,2023-03-13,Monday,Monday 2023-03-13
1616,1504,112,16,2023-03-12,Sunday,Sunday 2023-03-12
31109,24179,6930,7,2023-03-11,Saturday,Saturday 2023-03-11
33229,16375,16854,9,2023-03-10,Friday,Friday 2023-03-10
29256,9378,19878,12,2023-03-09,Thursday,Thursday 2023-03-09
33473,24526,8947,15,2023-03-08,Wednesday,Wednesday 2023-03-08
31698,12143,19555,14,2023-03-07,Tuesday,Tuesday 2023-03-07
1861,282,1579,16,2023-03-06,Monday,Monday 2023-03-06
1743,1609,134,19,2023-03-05,Sunday,Sunday 2023-03-05
34914,25386,9528,23,2023-03-04,Saturday,Saturday 2023-03-04
25789,2790,22999,14,2023-03-03,Friday,Friday 2023-03-03
28316,3917,24399,19,2023-03-02,Thursday,Thursday 2023-03-02
31346,20545,10801,13,2023-03-01,Wednesday,Wednesday 2023-03-01
22955,21472,1483,4,2023-02-28,Tuesday,Tuesday 2023-02-28
1506,26,1480,16,2023-02-27,Monday,Monday 2023-02-27
2258,519,1739,14,2023-02-26,Sunday,Sunday 2023-02-26
31557,1821,29736,6,2023-02-25,Saturday,Saturday 2023-02-25
27502,10020,17482,13,2023-02-24,Friday,Friday 2023-02-24
34183,5613,28570,18,2023-02-23,Thursday,Thursday 2023-02-23
27180,680,26500,19,2023-02-22,Wednesday,Wednesday 2023-02-22
31257,23182,8075,11,2023-02-21,Tuesday,Tuesday 2023-02-21
1580,822,758,17,2023-02-20,Monday,Monday 2023-02-20
1781,242,1539,17,2023-02-19,Sunday,Sunday 2023-02-19
27674,27214,460,9,2023-02-18,Saturday,Saturday 2023-02-18
25657,13986,11671,20,2023-02-17,Friday,Friday 2023-02-17
33650,654,32996,18,2023-02-16,Thursday,Thursday 2023-02-16
30903,16767,14136,14,2023-02-15,Wednesday,Wednesday 2023-02-15
26041,20374,5667,14,2023-02-14,Tuesday,Tuesday 2023-02-14
1951,1035,916,17,2023-02-13,Monday,Monday 2023-02-13
1825,425,1400,9,2023-02-12,Sunday,Sunday 2023-02-12
26721,9651,17070,14,2023-02-11,Saturday,Saturday 2023-02-11
30110,22309,7801,10,2023-02-10,Friday,Friday 2023-02-10
33788,26260,7528,8,2023-02-09,Thursday,Thursday 2023-02-09
25790,14337,11453,19,2023-02-08,Wednesday,Wednesday 2023-02-08
27637,17859,9778,3,2023-02-07,Tuesday,Tuesday 2023-02-07
1856,1087,769,16,2023-02-06,Monday,Monday 2023-02-06
2003,1185,818,30,2023-02-05,Sunday,Sunday 2023-02-05
31347,4353,26994,7,2023-02-04,Saturday,Saturday 2023-02-04
31442,20918,10524,18,2023-02-03,Friday,Friday 2023-02-03
27760,15912,11848,9,2023-02-02,Thursday,Thursday 2023-02-02
25459,1732,23727,4,2023-02-01,Wednesday,Wednesday 2023-02-01
27392,3175,24217,15,2023-01-31,Tuesday,Tuesday 2023-01-31
1855,1488,367,14,2023-01-30,Monday,Monday 2023-01-30
1754,1311,443,16,2023-01-29,Sunday,Sunday 2023-01-29
27460,22737,4723,13,2023-01-28,Saturday,Saturday 2023-01-28
21799,6321,15478,17,2023-01-27,Friday,Friday 2023-01-27
26369,18355,8014,10,2023-01-26,Thursday,Thursday 2023-01-26
33683,25012,8671,16,2023-01-25,Wednesday,Wednesday 2023-01-25
29183,9178,20005,16,2023-01-24,Tuesday,Tuesday 2023-01-24
1985,491,1494,21,2023-01-23,Monday,Monday 2023-01-23
1864,539,1325,9,2023-01-22,Sunday,Sunday 2023-01-22
32152,20934,11218,13,2023-01-21,Saturday,Saturday 2023-01-21
30884,30060,824,8,2023-01-20,Friday,Friday 2023-01-20
32914,21385,11529,10,2023-01-19,Thursday,Thursday 2023-01-19
29426,11343,18083,23,2023-01-18,Wednesday,Wednesday 2023-01-18
35581,20162,15419,13,2023-01-17,Tuesday,Tuesday 2023-01-17
1730,27,1703,25,2023-01-16,Monday,Monday 2023-01-16
2261,607,1654,29,2023-01-15,Sunday,Sunday 2023-01-15
31668,1022,30646,11,2023-01-14,Saturday,Saturday 2023-01-14
28334,3011,25323,7,2023-01-13,Friday,Friday 2023-01-13
31595,31037,558,17,2023-01-12,Thursday,Thursday 2023-01-12
25347,10574,14773,11,2023-01-11,Wednesday,Wednesday 2023-01-11
37545,37052,493,13,2023-01-10,Tuesday,Tuesday 2023-01-10
1841,1063,778,42,2023-01-09,Monday,Monday 2023-01-09
1726,1064,662,6,2023-01-08,Sunday,Sunday 2023-01-08
31733,15311,16422,6,2023-01-07,Saturday,Saturday 2023-01-07
29768,16244,13524,21,2023-01-06,Friday,Friday 2023-01-06
27898,9117,18781,15,2023-01-05,Thursday,Thursday 2023-01-05
31957,21693,10264,13,2023-01-04,Wednesday,Wednesday 2023-01-04
28759,24940,3819,10,2023-01-03,Tuesday,Tuesday 2023-01-03
1761,804,957,21,2023-01-02,Monday,Monday 2023-01-02
1869,1606,263,16,2023-01-01,Sunday,Sunday 2023-01-01
31017,15818,15199,13,2022-12-31,Saturday,Saturday 2022-12-31
35332,2248,33084,5,2022-12-30,Friday,Friday 2022-12-30
29796,28354,1442,19,2022-12-29,Thursday,Thursday 2022-12-29
35555,14476,21079,8,2022-12-28,Wednesday,Wednesday 2022-12-28
27069,24114,2955,26,2022-12-27,Tuesday,Tuesday 2022-12-27
1495,991,504,27,2022-12-26,Monday,Monday 2022-12-26
2127,1660,467,6,2022-12-25,Sunday,Sunday 2022-12-25
33186,22075,11111,3,2022-12-24,Saturday,Saturday 2022-12-24
24069,7284,16785,20,2022-12-23,Friday,Friday 2022-12-23
29675,12082,17593,8,2022-12-22,Thursday,Thursday 2022-12-22
23691,2830,20861,9,2022-12-21,Wednesday,Wednesday 2022-12-21
25746,7201,18545,18,2022-12-20,Tuesday,Tuesday 2022-12-20
1918,75,1843,16,2022-12-19,Monday,Monday 2022-12-19
2073,1517,556,25,2022-12-18,Sunday,Sunday 2022-12-18
23535,3454,20081,13,2022-12-17,Saturday,Saturday 2022-12-17
24049,16690,7359,24,2022-12-16,Friday,Friday 2022-12-16
29715,12417,17298,9,2022-12-15,Thursday,Thursday 2022-12-15
33630,12239,21391,18,2022-12-14,Wednesday,Wednesday 2022-12-14
29689,22116,7573,17,2022-12-13,Tuesday,Tuesday 2022-12-13
1482,788,694,19,2022-12-12,Monday,Monday 2022-12-12
1831,568,1263,30,2022-12-11,Sunday,Sunday 2022-12-11
32615,31366,1249,11,2022-12-10,Saturday,Saturday 2022-12-10
29980,5777,24203,4,2022-12-09,Friday,Friday 2022-12-09
27657,25910,1747,15,2022-12-08,Thursday,Thursday 2022-12-08
31706,18389,13317,12,2022-12-07,Wednesday,Wednesday 2022-12-07
37573,28923,8650,6,2022-12-06,Tuesday,Tuesday 2022-12-06
1485,681,804,25,2022-12-05,Monday,Monday 2022-12-05
2091,1031,1060,11,2022-12-04,Sunday,Sunday 2022-12-04
31596,29097,2499,14,2022-12-03,Saturday,Saturday 2022-12-03
35977,595,35382,12,2022-12-02,Friday,Friday 2022-12-02
27764,12014,15750,14,2022-12-01,Thursday,Thursday 2022-12-01
19699,18213,1486,13,2022-11-30,Wednesday,Wednesday 2022-11-30
31623,1853,29770,9,2022-11-29,Tuesday,Tuesday 2022-11-29
1873,1308,565,11,2022-11-28,Monday,Monday 2022-11-28
1727,1704,23,32,2022-11-27,Sunday,Sunday 2022-11-27
35441,28553,6888,6,2022-11-26,Saturday,Saturday 2022-11-26
27543,2562,24981,15,2022-11-25,Friday,Friday 2022-11-25
27062,16940,10122,16,2022-11-24,Thursday,Thursday 2022-11-24
31137,29623,1514,20,2022-11-23,Wednesday,Wednesday 2022-11-23
28516,4994,23522,5,2022-11-22,Tuesday,Tuesday 2022-11-22
1729,377,1352,16,2022-11-21,Monday,Monday 2022-11-21
1741,164,1577,21,2022-11-20,Sunday,Sunday 2022-11-20
30931,2935,27996,12,2022-11-19,Saturday,Saturday 2022-11-19
25308,1892,23416,17,2022-11-18,Friday,Friday 2022-11-18
35487,4304,31183,26,2022-11-17,Thursday,Thursday 2022-11-17
19413,9252,10161,11,2022-11-16,Wednesday,Wednesday 2022-11-16
31534,28039,3495,21,2022-11-15,Tuesday,Tuesday 2022-11-15
2344,149,2195,42,2022-11-14,Monday,Monday 2022-11-14
1761,21,1740,30,2022-11-13,Sunday,Sunday 2022-11-13
29686,21865,7821,14,2022-11-12,Saturday,Saturday 2022-11-12
26751,23146,3605,14,2022-11-11,Friday,Friday 2022-11-11
31720,19765,11955,18,2022-11-10,Thursday,Thursday 2022-11-10
32192,4147,28045,10,2022-11-09,Wednesday,Wednesday 2022-11-09
33280,15857,17423,30,2022-11-08,Tuesday,Tuesday 2022-11-08
1880,1362,518,22,2022-11-07,Monday,Monday 2022-11-07
1603,1579,24,14,2022-11-06,Sunday,Sunday 2022-11-06
29072,3306,25766,12,2022-11-05,Saturday,Saturday 2022-11-05
35929,15899,20030,14,2022-11-04,Friday,Friday 2022-11-04
31517,7541,23976,28,2022-11-03,Thursday,Thursday 2022-11-03
27431,6851,20580,20,2022-11-02,Wednesday,Wednesday 2022-11-02
25557,20777,4780,14,2022-11-01,Tuesday,Tuesday 2022-11-01
2212,1039,1173,21,2022-10-31,Monday,Monday 2022-10-31
1637,18,1619,27,2022-10-30,Sunday,Sunday 2022-10-30
21758,6261,15497,16,2022-10-29,Saturday,Saturday 2022-10-29
36821,19587,17234,11,2022-10-28,Friday,Friday 2022-10-28
29378,19685,9693,9,2022-10-27,Thursday,Thursday 2022-10-27
33077,29353,3724,19,2022-10-26,Wednesday,Wednesday 2022-10-26
29605,8862,20743,16,2022-10-25,Tuesday,Tuesday 2022-10-25
1588,318,1270,21,2022-10-24,Monday,Monday 2022-10-24
2090,783,1307,9,2022-10-23,Sunday,Sunday 2022-10-23
23638,5450,18188,10,2022-10-22,Saturday,Saturday 2022-10-22
32901,11307,21594,14,2022-10-21,Friday,Friday 2022-10-21
33714,33649,65,17,2022-10-20,Thursday,Thursday 2022-10-20
26459,25082,1377,10,2022-10-19,Wednesday,Wednesday 2022-10-19
29239,24112,5127,12,2022-10-18,Tuesday,Tuesday 2022-10-18
1629,97,1532,37,2022-10-17,Monday,Monday 2022-10-17
1856,956,900,32,2022-10-16,Sunday,Sunday 2022-10-16
30554,1623,28931,10,2022-10-15,Saturday,Saturday 2022-10-15
29275,29165,110,5,2022-10-14,Friday,Friday 2022-10-14
31678,5597,26081,12,2022-10-13,Thursday,Thursday 2022-10-13
26272,19970,6302,19,2022-10-12,Wednesday,Wednesday 2022-10-12
30994,8819,22175,25,2022-10-11,Tuesday,Tuesday 2022-10-11
1881,274,1607,17,2022-10-10,Monday,Monday 2022-10-10
1757,1122,635,19,2022-10-09,Sunday,Sunday 2022-10-09
28058,20508,7550,16,2022-10-08,Saturday,Saturday 2022-10-08
25569,21358,4211,14,2022-10-07,Friday,Friday 2022-10-07
31146,4783,26363,9,2022-10-06,Thursday,Thursday 2022-10-06
29859,29496,363,15,2022-10-05,Wednesday,Wednesday 2022-10-05
31609,14011,17598,6,2022-10-04,Tuesday,Tuesday 2022-10-04
2023,155,1868,29,2022-10-03,Monday,Monday 2022-10-03
1906,1518,388,34,2022-10-02,Sunday,Sunday 2022-10-02
37394,34792,2602,12,2022-10-01,Saturday,Saturday 2022-10-01
29712,19916,9796,18,2022-09-30,Friday,Friday 2022-09-30
31466,18486,12980,16,2022-09-29,Thursday,Thursday 2022-09-29
32128,24846,7282,6,2022-09-28,Wednesday,Wednesday 2022-09-28
28907,2061,26846,19,2022-09-27,Tuesday,Tuesday 2022-09-27
1483,668,815,14,2022-09-26,Monday,Monday 2022-09-26
1480,57,1423,16,2022-09-25,Sunday,Sunday 2022-09-25
33312,12166,21146,13,2022-09-24,Saturday,Saturday 2022-09-24
29006,14614,14392,13,2022-09-23,Friday,Friday 2022-09-23
33706,10288,23418,14,2022-09-22,Thursday,Thursday 2022-09-22
36244,29993,6251,13,2022-09-21,Wednesday,Wednesday 2022-09-21
21936,14586,7350,16,2022-09-20,Tuesday,Tuesday 2022-09-20
1586,307,1279,12,2022-09-19,Monday,Monday 2022-09-19
2093,663,1430,14,2022-09-18,Sunday,Sunday 2022-09-18
34123,24101,10022,11,2022-09-17,Saturday,Saturday 2022-09-17
33577,609,32968,11,2022-09-16,Friday,Friday 2022-09-16
36261,33367,2894,10,2022-09-15,Thursday,Thursday 2022-09-15
30645,19496,11149,17,2022-09-14,Wednesday,Wednesday 2022-09-14
32989,25281,7708,15,2022-09-13,Tuesday,Tuesday 2022-09-13
1884,1369,515,24,2022-09-12,Monday,Monday 2022-09-12
1965,286,1679,22,2022-09-11,Sunday,Sunday 2022-09-11
25627,17826,7801,14,2022-09-10,Saturday,Saturday 2022-09-10
25834,17849,7985,11,2022-09-09,Friday,Friday 2022-09-09
30909,8047,22862,18,2022-09-08,Thursday,Thursday 2022-09-08
22181,281,21900,14,2022-09-07,Wednesday,Wednesday 2022-09-07
32943,2818,30125,15,2022-09-06,Tuesday,Tuesday 2022-09-06
1709,1235,474,9,2022-09-05,Monday,Monday 2022-09-05
1965,505,1460,25,2022-09-04,Sunday,Sunday 2022-09-04
31112,28498,2614,12,2022-09-03,Saturday,Saturday 2022-09-03
24041,15852,8189,13,2022-09-02,Friday,Friday 2022-09-02
29546,3248,26298,21,2022-09-01,Thursday,Thursday 2022-09-01
30430,6768,23662,15,2022-08-31,Wednesday,Wednesday 2022-08-31
29126,8231,20895,16,2022-08-30,Tuesday,Tuesday 2022-08-30
2267,1328,939,22,2022-08-29,Monday,Monday 2022-08-29
1391,92,1299,22,2022-08-28,Sunday,Sunday 2022-08-28
27839,8579,19260,10,2022-08-27,Saturday,Saturday 2022-08-27
27502,12749,14753,26,2022-08-26,Friday,Friday 2022-08-26
37156,22026,15130,17,2022-08-25,Thursday,Thursday 2022-08-25
26311,13931,12380,34,2022-08-24,Wednesday,Wednesday 2022-08-24
30135,12697,17438,10,2022-08-23,Tuesday,Tuesday 2022-08-23
1725,568,1157,17,2022-08-22,Monday,Monday 2022-08-22
2069,1982,87,29,2022-08-21,Sunday,Sunday 2022-08-21
29913,3662,26251,12,2022-08-20,Saturday,Saturday 2022-08-20
25541,14699,10842,10,2022-08-19,Friday,Friday 2022-08-19
28992,10744,18248,5,2022-08-18,Thursday,Thursday 2022-08-18
29424,7145,22279,13,2022-08-17,Wednesday,Wednesday 2022-08-17
33707,13613,20094,6,2022-08-16,Tuesday,Tuesday 2022-08-16
2488,1323,1165,29,2022-08-15,Monday,Monday 2022-08-15
2232,1408,824,14,2022-08-14,Sunday,Sunday 2022-08-14
31559,11582,19977,6,2022-08-13,Saturday,Saturday 2022-08-13
27553,6628,20925,15,2022-08-12,Friday,Friday 2022-08-12
36019,29292,6727,15,2022-08-11,Thursday,Thursday 2022-08-11
32431,27349,5082,12,2022-08-10,Wednesday,Wednesday 2022-08-10
28039,9643,18396,15,2022-08-09,Tuesday,Tuesday 2022-08-09
1504,222,1282,11,2022-08-08,Monday,Monday 2022-08-08
1853,1300,553,16,2022-08-07,Sunday,Sunday 2022-08-07
27915,119,27796,13,2022-08-06,Saturday,Saturday 2022-08-06
32628,12137,20491,16,2022-08-05,Friday,Friday 2022-08-05
31475,5966,25509,13,2022-08-04,Thursday,Thursday 2022-08-04
31490,89,31401,29,2022-08-03,Wednesday,Wednesday 2022-08-03
27108,26256,852,16,2022-08-02,Tuesday,Tuesday 2022-08-02
2127,1229,898,25,2022-08-01,Monday,Monday 2022-08-01
2202,1973,229,24,2022-07-31,Sunday,Sunday 2022-07-31
33520,9433,24087,14,2022-07-30,Saturday,Saturday 2022-07-30
30241,6984,23257,8,2022-07-29,Friday,Friday 2022-07-29
27286,7766,19520,15,2022-07-28,Thursday,Thursday 2022-07-28
27442,8986,18456,16,2022-07-27,Wednesday,Wednesday 2022-07-27
26106,24590,1516,16,2022-07-26,Tuesday,Tuesday 2022-07-26
1981,1187,794,19,2022-07-25,Monday,Monday 2022-07-25
1705,510,1195,37,2022-07-24,Sunday,Sunday 2022-07-24
27231,17003,10228,16,2022-07-23,Saturday,Saturday 2022-07-23
33496,24233,9263,14,2022-07-22,Friday,Friday 2022-07-22
31505,21114,10391,9,2022-07-21,Thursday,Thursday 2022-07-21
31131,20299,10832,8,2022-07-20,Wednesday,Wednesday 2022-07-20
28374,4544,23830,9,2022-07-19,Tuesday,Tuesday 2022-07-19
1851,278,1573,22,2022-07-18,Monday,Monday 2022-07-18
1587,1587,0,17,2022-07-17,Sunday,Sunday 2022-07-17
36443,35197,1246,16,2022-07-16,Saturday,Saturday 2022-07-16
30986,256,30730,11,2022-07-15,Friday,Friday 2022-07-15
33872,31260,2612,17,2022-07-14,Thursday,Thursday 2022-07-14
31677,11829,19848,11,2022-07-13,Wednesday,Wednesday 2022-07-13
28001,13216,14785,13,2022-07-12,Tuesday,Tuesday 2022-07-12
2338,626,1712,16,2022-07-11,Monday,Monday 2022-07-11
1937,1544,393,24,2022-07-10,Sunday,Sunday 2022-07-10
31737,27962,3775,11,2022-07-09,Saturday,Saturday 2022-07-09
24124,20372,3752,7,2022-07-08,Friday,Friday 2022-07-08
25536,15421,10115,6,2022-07-07,Thursday,Thursday 2022-07-07
35155,11416,23739,8,2022-07-06,Wednesday,Wednesday 2022-07-06
25469,6431,19038,12,2022-07-05,Tuesday,Tuesday 2022-07-05
1606,1257,349,22,2022-07-04,Monday,Monday 2022-07-04
2110,1577,533,32,2022-07-03,Sunday,Sunday 2022-07-03
33031,29329,3702,15,2022-07-02,Saturday,Saturday 2022-07-02
31704,22838,8866,10,2022-07-01,Friday,Friday 2022-07-01
34018,5477,28541,9,2022-06-30,Thursday,Thursday 2022-06-30
27871,24044,3827,9,2022-06-29,Wednesday,Wednesday 2022-06-29
25387,10602,14785,7,2022-06-28,Tuesday,Tuesday 2022-06-28
1944,987,957,25,2022-06-27,Monday,Monday 2022-06-27
1842,412,1430,45,2022-06-26,Sunday,Sunday 2022-06-26
27695,25319,2376,21,2022-06-25,Saturday,Saturday 2022-06-25
25967,21343,4624,11,2022-06-24,Friday,Friday 2022-06-24
27846,14062,13784,21,2022-06-23,Thursday,Thursday 2022-06-23
35540,19292,16248,30,2022-06-22,Wednesday,Wednesday 2022-06-22
27691,25877,1814,7,2022-06-21,Tuesday,Tuesday 2022-06-21
2016,1554,462,22,2022-06-20,Monday,Monday 2022-06-20
2219,742,1477,25,2022-06-19,Sunday,Sunday 2022-06-19
29685,15673,14012,7,2022-06-18,Saturday,Saturday 2022-06-18
23682,13593,10089,15,2022-06-17,Friday,Friday 2022-06-17
32591,27354,5237,15,2022-06-16,Thursday,Thursday 2022-06-16
29863,26491,3372,9,2022-06-15,Wednesday,Wednesday 2022-06-15
31812,31260,552,7,2022-06-14,Tuesday,Tuesday 2022-06-14
2000,1357,643,29,2022-06-13,Monday,Monday 2022-06-13
1961,1469,492,40,2022-06-12,Sunday,Sunday 2022-06-12
30097,21640,8457,18,2022-06-11,Saturday,Saturday 2022-06-11
29312,20111,9201,28,2022-06-10,Friday,Friday 2022-06-10
31377,17019,14358,15,2022-06-09,Thursday,Thursday 2022-06-09
25770,17009,8761,7,2022-06-08,Wednesday,Wednesday 2022-06-08
25290,19566,5724,18,2022-06-07,Tuesday,Tuesday 2022-06-07
1881,1204,677,22,2022-06-06,Monday,Monday 2022-06-06
1997,1399,598,8,2022-06-05,Sunday,Sunday 2022-06-05
34026,4673,29353,9,2022-06-04,Saturday,Saturday 2022-06-04
25706,22231,3475,5,2022-06-03,Friday,Friday 2022-06-03
33136,2417,30719,13,2022-06-02,Thursday,Thursday 2022-06-02
35808,6939,28869,8,2022-06-01,Wednesday,Wednesday 2022-06-01
29610,12186,17424,11,2022-05-31,Tuesday,Tuesday 2022-05-31
1747,1622,125,25,2022-05-30,Monday,Monday 2022-05-30
1708,49,1659,29,2022-05-29,Sunday,Sunday 2022-05-29
33620,17152,16468,12,2022-05-28,Saturday,Saturday 2022-05-28
36123,6717,29406,6,2022-05-27,Friday,Friday 2022-05-27
29375,3005,26370,8,2022-05-26,Thursday,Thursday 2022-05-26
27353,24070,3283,10,2022-05-25,Wednesday,Wednesday 2022-05-25
33375,12299,21076,14,2022-05-24,Tuesday,Tuesday 2022-05-24
2076,885,1191,14,2022-05-23,Monday,Monday 2022-05-23
1771,388,1383,29,2022-05-22,Sunday,Sunday 2022-05-22
32887,4257,28630,14,2022-05-21,Saturday,Saturday 2022-05-21
25760,22568,3192,14,2022-05-20,Friday,Friday 2022-05-20
31147,26085,5062,12,2022-05-19,Thursday,Thursday 2022-05-19
29465,5692,23773,16,2022-05-18,Wednesday,Wednesday 2022-05-18
35154,7648,27506,13,2022-05-17,Tuesday,Tuesday 2022-05-17
1972,1184,788,21,2022-05-16,Monday,Monday 2022-05-16
1616,901,715,14,2022-05-15,Sunday,Sunday 2022-05-15
23376,14259,9117,7,2022-05-14,Saturday,Saturday 2022-05-14
19509,12093,7416,10,2022-05-13,Friday,Friday 2022-05-13
33743,274,33469,10,2022-05-12,Thursday,Thursday 2022-05-12
28738,11115,17623,25,2022-05-11,Wednesday,Wednesday 2022-05-11
35523,30999,4524,11,2022-05-10,Tuesday,Tuesday 2022-05-10
1374,1142,232,19,2022-05-09,Monday,Monday 2022-05-09
1890,400,1490,30,2022-05-08,Sunday,Sunday 2022-05-08
32325,4003,28322,10,2022-05-07,Saturday,Saturday 2022-05-07
28966,24822,4144,12,2022-05-06,Friday,Friday 2022-05-06
28931,11825,17106,9,2022-05-05,Thursday,Thursday 2022-05-05
32055,8542,23513,16,2022-05-04,Wednesday,Wednesday 2022-05-04
29633,27962,1671,15,2022-05-03,Tuesday,Tuesday 2022-05-03
1836,265,1571,19,2022-05-02,Monday,Monday 2022-05-02
1728,502,1226,24,2022-05-01,Sunday,Sunday 2022-05-01
23668,12798,10870,22,2022-04-30,Saturday,Saturday 2022-04-30
30520,2688,27832,14,2022-04-29,Friday,Friday 2022-04-29
29350,5174,24176,16,2022-04-28,Thursday,Thursday 2022-04-28
23664,12945,10719,19,2022-04-27,Wednesday,Wednesday 2022-04-27
25365,11708,13657,9,2022-04-26,Tuesday,Tuesday 2022-04-26
1900,1149,751,38,2022-04-25,Monday,Monday 2022-04-25
1861,117,1744,21,2022-04-24,Sunday,Sunday 2022-04-24
25092,15587,9505,21,2022-04-23,Saturday,Saturday 2022-04-23
29631,12462,17169,8,2022-04-22,Friday,Friday 2022-04-22
25694,2123,23571,18,2022-04-21,Thursday,Thursday 2022-04-21
34003,25465,8538,6,2022-04-20,Wednesday,Wednesday 2022-04-20
30144,14266,15878,13,2022-04-19,Tuesday,Tuesday 2022-04-19
1883,1812,71,24,2022-04-18,Monday,Monday 2022-04-18
1958,216,1742,25,2022-04-17,Sunday,Sunday 2022-04-17
30667,13165,17502,8,2022-04-16,Saturday,Saturday 2022-04-16
40042,15363,24679,22,2022-04-15,Friday,Friday 2022-04-15
31618,25825,5793,6,2022-04-14,Thursday,Thursday 2022-04-14
23790,3392,20398,28,2022-04-13,Wednesday,Wednesday 2022-04-13
32797,3598,29199,22,2022-04-12,Tuesday,Tuesday 2022-04-12
960,858,102,11,2022-04-11,Monday,Monday 2022-04-11
1732,1337,395,30,2022-04-10,Sunday,Sunday 2022-04-10
27533,9136,18397,18,2022-04-09,Saturday,Saturday 2022-04-09
27379,21026,6353,10,2022-04-08,Friday,Friday 2022-04-08
25334,18842,6492,10,2022-04-07,Thursday,Thursday 2022-04-07
27009,7948,19061,20,2022-04-06,Wednesday,Wednesday 2022-04-06
26441,11918,14523,9,2022-04-05,Tuesday,Tuesday 2022-04-05
1717,1071,646,11,2022-04-04,Monday,Monday 2022-04-04
1966,390,1576,22,2022-04-03,Sunday,Sunday 2022-04-03
35042,30041,5001,15,2022-04-02,Saturday,Saturday 2022-04-02
28996,27930,1066,10,2022-04-01,Friday,Friday 2022-04-01
29915,13509,16406,10,2022-03-31,Thursday,Thursday 2022-03-31
29831,21064,8767,17,2022-03-30,Wednesday,Wednesday 2022-03-30
25896,362,25534,11,2022-03-29,Tuesday,Tuesday 2022-03-29
1734,487,1247,21,2022-03-28,Monday,Monday 2022-03-28
2090,954,1136,19,2022-03-27,Sunday,Sunday 2022-03-27
31025,2480,28545,4,2022-03-26,Saturday,Saturday 2022-03-26
38044,29071,8973,6,2022-03-25,Friday,Friday 2022-03-25
27334,6681,20653,19,2022-03-24,Thursday,Thursday 2022-03-24
35386,26801,8585,15,2022-03-23,Wednesday,Wednesday 2022-03-23
35741,11501,24240,17,2022-03-22,Tuesday,Tuesday 2022-03-22
1970,1457,513,21,2022-03-21,Monday,Monday 2022-03-21
1876,7,1869,19,2022-03-20,Sunday,Sunday 2022-03-20
30646,7611,23035,6,2022-03-19,Saturday,Saturday 2022-03-19
33661,25139,8522,8,2022-03-18,Friday,Friday 2022-03-18
27638,21244,6394,13,2022-03-17,Thursday,Thursday 2022-03-17
31407,19570,11837,22,2022-03-16,Wednesday,Wednesday 2022-03-16
33645,25582,8063,18,2022-03-15,Tuesday,Tuesday 2022-03-15
1866,895,971,4,2022-03-14,Monday,Monday 2022-03-14
1947,66,1881,16,2022-03-13,Sunday,Sunday 2022-03-13
26242,24478,1764,11,2022-03-12,Saturday,Saturday 2022-03-12
19724,19401,323,5,2022-03-11,Friday,Friday 2022-03-11
29713,26382,3331,19,2022-03-10,Thursday,Thursday 2022-03-10
31298,22292,9006,21,2022-03-09,Wednesday,Wednesday 2022-03-09
29685,7658,22027,9,2022-03-08,Tuesday,Tuesday 2022-03-08
1942,952,990,12,2022-03-07,Monday,Monday 2022-03-07
2120,1883,237,17,2022-03-06,Sunday,Sunday 2022-03-06
29677,257,29420,14,2022-03-05,Saturday,Saturday 2022-03-05
25886,18523,7363,17,2022-03-04,Friday,Friday 2022-03-04
27515,22620,4895,8,2022-03-03,Thursday,Thursday 2022-03-03
25258,12078,13180,12,2022-03-02,Wednesday,Wednesday 2022-03-02
25716,23496,2220,6,2022-03-01,Tuesday,Tuesday 2022-03-01
1637,1023,614,27,2022-02-28,Monday,Monday 2022-02-28
1337,1309,28,21,2022-02-27,Sunday,Sunday 2022-02-27
30011,9998,20013,14,2022-02-26,Saturday,Saturday 2022-02-26
37609,22254,15355,11,2022-02-25,Friday,Friday 2022-02-25
29231,26732,2499,9,2022-02-24,Thursday,Thursday 2022-02-24
29242,847,28395,8,2022-02-23,Wednesday,Wednesday 2022-02-23
35727,4007,31720,6,2022-02-22,Tuesday,Tuesday 2022-02-22
1996,585,1411,22,2022-02-21,Monday,Monday 2022-02-21
1113,98,1015,21,2022-02-20,Sunday,Sunday 2022-02-20
25636,9045,16591,15,2022-02-19,Saturday,Saturday 2022-02-19
27404,25893,1511,14,2022-02-18,Friday,Friday 2022-02-18
27350,16525,10825,9,2022-02-17,Thursday,Thursday 2022-02-17
33598,5991,27607,16,2022-02-16,Wednesday,Wednesday 2022-02-16
26079,13972,12107,4,2022-02-15,Tuesday,Tuesday 2022-02-15
1744,986,758,8,2022-02-14,Monday,Monday 2022-02-14
2109,1600,509,19,2022-02-13,Sunday,Sunday 2022-02-13
22308,11668,10640,12,2022-02-12,Saturday,Saturday 2022-02-12
29178,27453,1725,11,2022-02-11,Friday,Friday 2022-02-11
33986,19568,14418,18,2022-02-10,Thursday,Thursday 2022-02-10
23483,19155,4328,15,2022-02-09,Wednesday,Wednesday 2022-02-09
29712,28735,977,16,2022-02-08,Tuesday,Tuesday 2022-02-08
1859,1654,205,27,2022-02-07,Monday,Monday 2022-02-07
2248,1218,1030,16,2022-02-06,Sunday,Sunday 2022-02-06
31804,4683,27121,16,2022-02-05,Saturday,Saturday 2022-02-05
33695,4847,28848,5,2022-02-04,Friday,Friday 2022-02-04
39395,10030,29365,14,2022-02-03,Thursday,Thursday 2022-02-03
29501,3998,25503,16,2022-02-02,Wednesday,Wednesday 2022-02-02
23668,9160,14508,9,2022-02-01,Tuesday,Tuesday 2022-02-01
1351,1244,107,11,2022-01-31,Monday,Monday 2022-01-31
1516,72,1444,34,2022-01-30,Sunday,Sunday 2022-01-30
30223,13241,16982,10,2022-01-29,Saturday,Saturday 2022-01-29
30076,6370,23706,17,2022-01-28,Friday,Friday 2022-01-28
38493,21639,16854,14,2022-01-27,Thursday,Thursday 2022-01-27
33876,21931,11945,15,2022-01-26,Wednesday,Wednesday 2022-01-26
25603,23331,2272,16,2022-01-25,Tuesday,Tuesday 2022-01-25
1585,33,1552,9,2022-01-24,Monday,Monday 2022-01-24
1837,540,1297,9,2022-01-23,Sunday,Sunday 2022-01-23
37326,1699,35627,10,2022-01-22,Saturday,Saturday 2022-01-22
27641,21926,5715,15,2022-01-21,Friday,Friday 2022-01-21
19943,10689,9254,11,2022-01-20,Thursday,Thursday 2022-01-20
26964,12330,14634,12,2022-01-19,Wednesday,Wednesday 2022-01-19
27378,15551,11827,17,2022-01-18,Tuesday,Tuesday 2022-01-18
2231,1127,1104,19,2022-01-17,Monday,Monday 2022-01-17
1370,360,1010,16,2022-01-16,Sunday,Sunday 2022-01-16
25189,7765,17424,17,2022-01-15,Saturday,Saturday 2022-01-15
29397,29266,131,7,2022-01-14,Friday,Friday 2022-01-14
28540,25088,3452,9,2022-01-13,Thursday,Thursday 2022-01-13
34191,18789,15402,14,2022-01-12,Wednesday,Wednesday 2022-01-12
32975,7302,25673,14,2022-01-11,Tuesday,Tuesday 2022-01-11
1735,1055,680,9,2022-01-10,Monday,Monday 2022-01-10
2278,488,1790,21,2022-01-09,Sunday,Sunday 2022-01-09
29901,13450,16451,8,2022-01-08,Saturday,Saturday 2022-01-08
31861,22837,9024,11,2022-01-07,Friday,Friday 2022-01-07
33156,14806,18350,5,2022-01-06,Thursday,Thursday 2022-01-06
31195,1826,29369,20,2022-01-05,Wednesday,Wednesday 2022-01-05
24147,20311,3836,18,2022-01-04,Tuesday,Tuesday 2022-01-04
1721,787,934,29,2022-01-03,Monday,Monday 2022-01-03
1787,1488,299,16,2022-01-02,Sunday,Sunday 2022-01-02
26906,6589,20317,15,2022-01-01,Saturday,Saturday 2022-01-01
28068,26269,1799,11,2021-12-31,Friday,Friday 2021-12-31
30262,3554,26708,22,2021-12-30,Thursday,Thursday 2021-12-30
36129,22508,13621,17,2021-12-29,Wednesday,Wednesday 2021-12-29
25049,20797,4252,16,2021-12-28,Tuesday,Tuesday 2021-12-28
2233,81,2152,21,2021-12-27,Monday,Monday 2021-12-27
1868,823,1045,12,2021-12-26,Sunday,Sunday 2021-12-26
36051,7230,28821,18,2021-12-25,Saturday,Saturday 2021-12-25
30687,13719,16968,25,2021-12-24,Friday,Friday 2021-12-24
34716,13893,20823,11,2021-12-23,Thursday,Thursday 2021-12-23
30275,10485,19790,20,2021-12-22,Wednesday,Wednesday 2021-12-22
35331,3674,31657,19,2021-12-21,Tuesday,Tuesday 2021-12-21
1869,1827,42,24,2021-12-20,Monday,Monday 2021-12-20
2121,1139,982,11,2021-12-19,Sunday,Sunday 2021-12-19
31866,12313,19553,9,2021-12-18,Saturday,Saturday 2021-12-18
36705,852,35853,4,2021-12-17,Friday,Friday 2021-12-17
27480,10364,17116,11,2021-12-16,Thursday,Thursday 2021-12-16
33552,11905,21647,6,2021-12-15,Wednesday,Wednesday 2021-12-15
29894,2934,26960,12,2021-12-14,Tuesday,Tuesday 2021-12-14
1845,371,1474,16,2021-12-13,Monday,Monday 2021-12-13
1592,289,1303,25,2021-12-12,Sunday,Sunday 2021-12-12
29338,18568,10770,21,2021-12-11,Saturday,Saturday 2021-12-11
32775,5643,27132,20,2021-12-10,Friday,Friday 2021-12-10
31495,26958,4537,15,2021-12-09,Thursday,Thursday 2021-12-09
38945,21226,17719,13,2021-12-08,Wednesday,Wednesday 2021-12-08
19271,9533,9738,14,2021-12-07,Tuesday,Tuesday 2021-12-07
1346,597,749,17,2021-12-06,Monday,Monday 2021-12-06
2118,95,2023,9,2021-12-05,Sunday,Sunday 2021-12-05
21355,4352,17003,17,2021-12-04,Saturday,Saturday 2021-12-04
33416,31376,2040,12,2021-12-03,Friday,Friday 2021-12-03
29259,28932,327,17,2021-12-02,Thursday,Thursday 2021-12-02
27263,2934,24329,19,2021-12-01,Wednesday,Wednesday 2021-12-01
34052,7292,26760,16,2021-11-30,Tuesday,Tuesday 2021-11-30
1872,1000,872,17,2021-11-29,Monday,Monday 2021-11-29
1986,1739,247,17,2021-11-28,Sunday,Sunday 2021-11-28
34428,8380,26048,18,2021-11-27,Saturday,Saturday 2021-11-27
32431,11019,21412,14,2021-11-26,Friday,Friday 2021-11-26
33811,24007,9804,12,2021-11-25,Thursday,Thursday 2021-11-25
28303,3881,24422,12,2021-11-24,Wednesday,Wednesday 2021-11-24
34082,26839,7243,9,2021-11-23,Tuesday,Tuesday 2021-11-23
1871,1217,654,22,2021-11-22,Monday,Monday 2021-11-22
2012,563,1449,14,2021-11-21,Sunday,Sunday 2021-11-21
31801,12795,19006,10,2021-11-20,Saturday,Saturday 2021-11-20
23531,5441,18090,7,2021-11-19,Friday,Friday 2021-11-19
26745,3927,22818,6,2021-11-18,Thursday,Thursday 2021-11-18
31241,8731,22510,9,2021-11-17,Wednesday,Wednesday 2021-11-17
33623,22319,11304,17,2021-11-16,Tuesday,Tuesday 2021-11-16
2225,1089,1136,8,2021-11-15,Monday,Monday 2021-11-15
2106,496,1610,29,2021-11-14,Sunday,Sunday 2021-11-14
25219,22742,2477,17,2021-11-13,Saturday,Saturday 2021-11-13
31657,24013,7644,10,2021-11-12,Friday,Friday 2021-11-12
27968,8801,19167,10,2021-11-11,Thursday,Thursday 2021-11-11
29343,11210,18133,12,2021-11-10,Wednesday,Wednesday 2021-11-10
25870,3116,22754,19,2021-11-09,Tuesday,Tuesday 2021-11-09
2009,1875,134,16,2021-11-08,Monday,Monday 2021-11-08
1625,1500,125,30,2021-11-07,Sunday,Sunday 2021-11-07
27695,18652,9043,18,2021-11-06,Saturday,Saturday 2021-11-06
29517,714,28803,19,2021-11-05,Friday,Friday 2021-11-05
34760,13627,21133,10,2021-11-04,Thursday,Thursday 2021-11-04
31616,22872,8744,16,2021-11-03,Wednesday,Wednesday 2021-11-03
30159,5187,24972,11,2021-11-02,Tuesday,Tuesday 2021-11-02
1716,1111,605,37,2021-11-01,Monday,Monday 2021-11-01
1864,139,1725,12,2021-10-31,Sunday,Sunday 2021-10-31
23662,4866,18796,16,2021-10-30,Saturday,Saturday 2021-10-30
27660,1729,25931,15,2021-10-29,Friday,Friday 2021-10-29
27731,3070,24661,17,2021-10-28,Thursday,Thursday 2021-10-28
33709,7217,26492,17,2021-10-27,Wednesday,Wednesday 2021-10-27
31546,13137,18409,9,2021-10-26,Tuesday,Tuesday 2021-10-26
1917,1653,264,42,2021-10-25,Monday,Monday 2021-10-25
2342,1781,561,35,2021-10-24,Sunday,Sunday 2021-10-24
31715,2407,29308,8,2021-10-23,Saturday,Saturday 2021-10-23
17755,12000,5755,7,2021-10-22,Friday,Friday 2021-10-22
36092,32700,3392,9,2021-10-21,Thursday,Thursday 2021-10-21
25765,15146,10619,8,2021-10-20,Wednesday,Wednesday 2021-10-20
28331,287,28044,25,2021-10-19,Tuesday,Tuesday 2021-10-19
2239,627,1612,27,2021-10-18,Monday,Monday 2021-10-18
1832,1252,580,27,2021-10-17,Sunday,Sunday 2021-10-17
29935,15364,14571,14,2021-10-16,Saturday,Saturday 2021-10-16
25463,77,25386,9,2021-10-15,Friday,Friday 2021-10-15
29998,26111,3887,15,2021-10-14,Thursday,Thursday 2021-10-14
21773,11846,9927,16,2021-10-13,Wednesday,Wednesday 2021-10-13
19290,8182,11108,10,2021-10-12,Tuesday,Tuesday 2021-10-12
1856,849,1007,22,2021-10-11,Monday,Monday 2021-10-11
1716,1015,701,19,2021-10-10,Sunday,Sunday 2021-10-10
25491,20458,5033,17,2021-10-09,Saturday,Saturday 2021-10-09
28008,1792,26216,10,2021-10-08,Friday,Friday 2021-10-08
35271,29445,5826,9,2021-10-07,Thursday,Thursday 2021-10-07
29117,23349,5768,13,2021-10-06,Wednesday,Wednesday 2021-10-06
27376,20547,6829,6,2021-10-05,Tuesday,Tuesday 2021-10-05
1855,433,1422,21,2021-10-04,Monday,Monday 2021-10-04
1606,367,1239,11,2021-10-03,Sunday,Sunday 2021-10-03
33513,13611,19902,24,2021-10-02,Saturday,Saturday 2021-10-02
31679,1530,30149,7,2021-10-01,Friday,Friday 2021-10-01
31585,4613,26972,13,2021-09-30,Thursday,Thursday 2021-09-30
23353,8397,14956,7,2021-09-29,Wednesday,Wednesday 2021-09-29
29355,11566,17789,9,2021-09-28,Tuesday,Tuesday 2021-09-28
1804,586,1218,24,2021-09-27,Monday,Monday 2021-09-27
2044,1620,424,19,2021-09-26,Sunday,Sunday 2021-09-26
25977,18552,7425,8,2021-09-25,Saturday,Saturday 2021-09-25
29764,16704,13060,12,2021-09-24,Friday,Friday 2021-09-24
31115,13532,17583,11,2021-09-23,Thursday,Thursday 2021-09-23
27665,140,27525,18,2021-09-22,Wednesday,Wednesday 2021-09-22
27803,4826,22977,15,2021-09-21,Tuesday,Tuesday 2021-09-21
1938,447,1491,17,2021-09-20,Monday,Monday 2021-09-20
2243,1038,1205,17,2021-09-19,Sunday,Sunday 2021-09-19
23738,15119,8619,18,2021-09-18,Saturday,Saturday 2021-09-18
25389,11031,14358,12,2021-09-17,Friday,Friday 2021-09-17
29549,15078,14471,14,2021-09-16,Thursday,Thursday 2021-09-16
32064,17235,14829,10,2021-09-15,Wednesday,Wednesday 2021-09-15
27894,11584,16310,14,2021-09-14,Tuesday,Tuesday 2021-09-14
2095,1012,1083,24,2021-09-13,Monday,Monday 2021-09-13
2121,1378,743,4,2021-09-12,Sunday,Sunday 2021-09-12
33260,7917,25343,11,2021-09-11,Saturday,Saturday 2021-09-11
33618,22986,10632,19,2021-09-10,Friday,Friday 2021-09-10
28287,17463,10824,6,2021-09-09,Thursday,Thursday 2021-09-09
29317,12908,16409,12,2021-09-08,Wednesday,Wednesday 2021-09-08
33752,8871,24881,11,2021-09-07,Tuesday,Tuesday 2021-09-07
2257,1924,333,34,2021-09-06,Monday,Monday 2021-09-06
1877,427,1450,19,2021-09-05,Sunday,Sunday 2021-09-05
21893,15339,6554,10,2021-09-04,Saturday,Saturday 2021-09-04
25632,5934,19698,17,2021-09-03,Friday,Friday 2021-09-03
26259,3140,23119,9,2021-09-02,Thursday,Thursday 2021-09-02
25405,22036,3369,18,2021-09-01,Wednesday,Wednesday 2021-09-01
28071,13318,14753,17,2021-08-31,Tuesday,Tuesday 2021-08-31
2070,185,1885,29,2021-08-30,Monday,Monday 2021-08-30
1997,1089,908,12,2021-08-29,Sunday,Sunday 2021-08-29
31334,23439,7895,10,2021-08-28,Saturday,Saturday 2021-08-28
30010,7302,22708,9,2021-08-27,Friday,Friday 2021-08-27
31509,2524,28985,10,2021-08-26,Thursday,Thursday 2021-08-26
31838,26392,5446,14,2021-08-25,Wednesday,Wednesday 2021-08-25
31134,6880,24254,15,2021-08-24,Tuesday,Tuesday 2021-08-24
2146,1646,500,19,2021-08-23,Monday,Monday 2021-08-23
1861,1104,757,8,2021-08-22,Sunday,Sunday 2021-08-22
24926,10411,14515,6,2021-08-21,Saturday,Saturday 2021-08-21
27204,21431,5773,9,2021-08-20,Friday,Friday 2021-08-20
33326,6509,26817,8,2021-08-19,Thursday,Thursday 2021-08-19
27533,23345,4188,17,2021-08-18,Wednesday,Wednesday 2021-08-18
27886,10582,17304,10,2021-08-17,Tuesday,Tuesday 2021-08-17
1629,354,1275,34,2021-08-16,Monday,Monday 2021-08-16
1719,645,1074,12,2021-08-15,Sunday,Sunday 2021-08-15
35048,17375,17673,13,2021-08-14,Saturday,Saturday 2021-08-14
29502,17709,11793,8,2021-08-13,Friday,Friday 2021-08-13
30291,24293,5998,11,2021-08-12,Thursday,Thursday 2021-08-12
28971,25692,3279,13,2021-08-11,Wednesday,Wednesday 2021-08-11
31801,20905,10896,12,2021-08-10,Tuesday,Tuesday 2021-08-10
1716,143,1573,8,2021-08-09,Monday,Monday 2021-08-09
1639,85,1554,12,2021-08-08,Sunday,Sunday 2021-08-08
34852,26815,8037,15,2021-08-07,Saturday,Saturday 2021-08-07
31262,17281,13981,9,2021-08-06,Friday,Friday 2021-08-06
36537,13403,23134,16,2021-08-05,Thursday,Thursday 2021-08-05
21774,16457,5317,5,2021-08-04,Wednesday,Wednesday 2021-08-04
29837,10815,19022,13,2021-08-03,Tuesday,Tuesday 2021-08-03
1495,876,619,42,2021-08-02,Monday,Monday 2021-08-02
2194,682,1512,24,2021-08-01,Sunday,Sunday 2021-08-01
22127,412,21715,11,2021-07-31,Saturday,Saturday 2021-07-31
24665,6624,18041,19,2021-07-30,Friday,Friday 2021-07-30
26596,24744,1852,4,2021-07-29,Thursday,Thursday 2021-07-29
34218,2501,31717,11,2021-07-28,Wednesday,Wednesday 2021-07-28
29740,15574,14166,14,2021-07-27,Tuesday,Tuesday 2021-07-27
1493,501,992,22,2021-07-26,Monday,Monday 2021-07-26
2092,225,1867,37,2021-07-25,Sunday,Sunday 2021-07-25
33378,9285,24093,14,2021-07-24,Saturday,Saturday 2021-07-24
29670,27007,2663,13,2021-07-23,Friday,Friday 2021-07-23
23875,16841,7034,19,2021-07-22,Thursday,Thursday 2021-07-22
32185,31313,872,11,2021-07-21,Wednesday,Wednesday 2021-07-21
27417,10037,17380,22,2021-07-20,Tuesday,Tuesday 2021-07-20
1742,840,902,9,2021-07-19,Monday,Monday 2021-07-19
1349,332,1017,29,2021-07-18,Sunday,Sunday 2021-07-18
29279,2651,26628,8,2021-07-17,Saturday,Saturday 2021-07-17
29474,9330,20144,12,2021-07-16,Friday,Friday 2021-07-16
31888,12751,19137,22,2021-07-15,Thursday,Thursday 2021-07-15
35144,18943,16201,18,2021-07-14,Wednesday,Wednesday 2021-07-14
37158,14319,22839,11,2021-07-13,Tuesday,Tuesday 2021-07-13
2255,719,1536,22,2021-07-12,Monday,Monday 2021-07-12
1973,33,1940,29,2021-07-11,Sunday,Sunday 2021-07-11
33431,14153,19278,22,2021-07-10,Saturday,Saturday 2021-07-10
31688,11811,19877,12,2021-07-09,Friday,Friday 2021-07-09
30133,3809,26324,25,2021-07-08,Thursday,Thursday 2021-07-08
28117,25485,2632,9,2021-07-07,Wednesday,Wednesday 2021-07-07
31841,31043,798,12,2021-07-06,Tuesday,Tuesday 2021-07-06
1817,707,1110,11,2021-07-05,Monday,Monday 2021-07-05
1495,722,773,25,2021-07-04,Sunday,Sunday 2021-07-04
29716,611,29105,14,2021-07-03,Saturday,Saturday 2021-07-03
31720,26400,5320,6,2021-07-02,Friday,Friday 2021-07-02
29483,12614,16869,9,2021-07-01,Thursday,Thursday 2021-07-01
33937,10534,23403,10,2021-06-30,Wednesday,Wednesday 2021-06-30
23878,15485,8393,17,2021-06-29,Tuesday,Tuesday 2021-06-29
1884,1463,421,37,2021-06-28,Monday,Monday 2021-06-28
2201,1730,471,19,2021-06-27,Sunday,Sunday 2021-06-27
36464,13580,22884,8,2021-06-26,Saturday,Saturday 2021-06-26
31471,23827,7644,7,2021-06-25,Friday,Friday 2021-06-25
23708,1169,22539,15,2021-06-24,Thursday,Thursday 2021-06-24
27771,17954,9817,11,2021-06-23,Wednesday,Wednesday 2021-06-23
29350,16724,12626,15,2021-06-22,Tuesday,Tuesday 2021-06-22
1479,437,1042,11,2021-06-21,Monday,Monday 2021-06-21
2191,1571,620,24,2021-06-20,Sunday,Sunday 2021-06-20
23521,3793,19728,8,2021-06-19,Saturday,Saturday 2021-06-19
32994,29436,3558,7,2021-06-18,Friday,Friday 2021-06-18
27407,2807,24600,15,2021-06-17,Thursday,Thursday 2021-06-17
28838,25194,3644,15,2021-06-16,Wednesday,Wednesday 2021-06-16
31737,11348,20389,24,2021-06-15,Tuesday,Tuesday 2021-06-15
2003,1925,78,17,2021-06-14,Monday,Monday 2021-06-14
1871,1658,213,16,2021-06-13,Sunday,Sunday 2021-06-13
33346,27414,5932,13,2021-06-12,Saturday,Saturday 2021-06-12
27632,605,27027,22,2021-06-11,Friday,Friday 2021-06-11
30259,6063,24196,11,2021-06-10,Thursday,Thursday 2021-06-10
27564,14096,13468,9,2021-06-09,Wednesday,Wednesday 2021-06-09
29043,14098,14945,20,2021-06-08,Tuesday,Tuesday 2021-06-08
1471,768,703,17,2021-06-07,Monday,Monday 2021-06-07
1888,1092,796,14,2021-06-06,Sunday,Sunday 2021-06-06
33962,3018,30944,8,2021-06-05,Saturday,Saturday 2021-06-05
30282,29977,305,6,2021-06-04,Friday,Friday 2021-06-04
31015,25758,5257,17,2021-06-03,Thursday,Thursday 2021-06-03
27485,18484,9001,19,2021-06-02,Wednesday,Wednesday 2021-06-02
27379,17692,9687,5,2021-06-01,Tuesday,Tuesday 2021-06-01
2194,1466,728,40,2021-05-31,Monday,Monday 2021-05-31
2013,167,1846,38,2021-05-30,Sunday,Sunday 2021-05-30
31532,20990,10542,10,,,
35982,1719,34263,13,,,
31296,14584,16712,5,,,
31579,28050,3529,23,,,
32098,24675,7423,15,,,
31778,30015,1763,27,,,
32527,16954,15573,18,,,
31733,12820,18913,18,,,
29418,14800,14618,13,,,
29104,23202,5902,13,,,
27718,2175,25543,29,,,
29510,862,28648,12,,,
27384,21704,5680,15,,,
31583,10436,21147,12,,,
29078,15860,13218,9,,,
31199,18319,12880,15,,,
23661,539,23122,18,,,
26829,10299,16530,10,,,
33515,11905,21610,18,,,
25789,2119,23670,17,,,
26107,8913,17194,11,,,
21072,16841,4231,16,,,
31592,26788,4804,15,,,
27447,23929,3518,15,,,
33814,30719,3095,15,,,
29498,25199,4299,22,,,
31567,15198,16369,11,,,
38695,21598,17097,4,,,
39267,4045,35222,19,,,
27391,6725,20666,18,,,
29484,24177,5307,13,,,
24857,5514,19343,8,,,
25785,22789,2996,19,,,
33298,16860,16438,16,,,
25322,17166,8156,16,,,
26865,14110,12755,14,,,
29056,20453,8603,13,,,
28945,1077,27868,9,,,
28733,24743,3990,15,,,
33316,59,33257,8,,,
29218,10484,18734,10,,,
31801,24400,7401,14,,,
30457,16639,13818,11,,,
29464,20178,9286,18,,,
21702,10700,11002,16,,,
29142,17316,11826,11,,,
28325,4392,23933,11,,,
39738,12019,27719,12,,,
29211,16132,13079,20,,,
33172,15998,17174,15,,,
33720,23680,10040,9,,,
23538,16406,7132,5,,,
26078,24796,1282,27,,,
27156,19121,8035,14,,,
31575,28873,2702,11,,,
31073,1946,29127,21,,,
31346,23422,7924,4,,,
28952,21658,7294,28,,,
28793,27470,1323,16,,,
27964,612,27352,15,,,
27299,15450,11849,13,,,
29248,19983,9265,16,,,
31926,7397,24529,18,,,
29246,27354,1892,12,,,
27544,20318,7226,9,,,
29270,14952,14318,14,,,
28740,16312,12428,28,,,
28918,17231,11687,18,,,
31462,19818,11644,14,,,
32335,6381,25954,14,,,
23986,204,23782,13,,,
31630,1886,29744,20,,,
28328,11476,16852,10,,,
25613,23727,1886,17,,,
27796,27168,628,15,,,
29026,17068,11958,15,,,
33943,5120,28823,17,,,
33809,13657,20152,10,,,
33659,16552,17107,16,,,
25649,5335,20314,17,,,
35298,26558,8740,9,,,
27269,24421,2848,15,,,
29323,11876,17447,6,,,
35988,33717,2271,17,,,
32053,30437,1616,17,,,
37649,30682,6967,17,,,
27802,14580,13222,7,,,
35358,35286,72,9,,,
29805,5035,24770,11,,,
23587,20149,3438,12,,,
33655,4192,29463,25,,,
27601,2052,25549,16,,,
31637,17492,14145,21,,,
31040,25075,5965,8,,,
29816,27818,1998,20,,,
20435,8907,11528,17,,,
21783,14723,7060,18,,,
25787,22386,3401,14,,,
34973,17474,17499,17,,,
35784,25456,10328,10,,,
33880,33604,276,13,,,
28396,25376,3020,16,,,
31983,3981,28002,4,,,
23699,23491,208,21,,,
29134,11702,17432,6,,,
29572,16584,12988,12,,,
23461,310,23151,12,,,
31655,1664,29991,6,,,
27492,4714,22778,17,,,
27233,14546,12687,18,,,
29360,6130,23230,15,,,
25892,18175,7717,18,,,
29541,3016,26525,17,,,
31002,15667,15335,15,,,
30163,24988,5175,11,,,
25669,22700,2969,13,,,
36872,8228,28644,17,,,
27674,4815,22859,20,,,
24994,21737,3257,9,,,
28069,24896,3173,15,,,
36012,24668,11344,23,,,
29763,7138,22625,5,,,
29424,16168,13256,20,,,
29483,9401,20082,9,,,
23868,3675,20193,15,,,
34401,32667,1734,19,,,
34015,13709,20306,17,,,
26648,20005,6643,9,,,
34215,7921,26294,18,,,
25939,15153,10786,6,,,
31542,8583,22959,10,,,
25080,21139,3941,12,,,
31750,6022,25728,18,,,
29566,10518,19048,12,,,
24310,9140,15170,7,,,
26147,6233,19914,16,,,
23009,5587,17422,19,,,
27923,7922,20001,14,,,
33853,3446,30407,8,,,
27008,2536,24472,9,,,
27337,20222,7115,10,,,
32058,10886,21172,15,,,
36107,32588,3519,22,,,
29287,16796,12491,22,,,
31723,3177,28546,8,,,
31994,31060,934,30,,,
30321,12286,18035,20,,,
25251,17224,8027,5,,,
25520,1437,24083,9,,,
23094,12040,11054,9,,,
27786,15498,12288,11,,,
25878,17765,8113,14,,,
27638,10558,17080,23,,,
23958,13669,10289,13,,,
25623,12240,13383,24,,,
35125,727,34398,23,,,
36043,3456,32587,17,,,
29319,17815,11504,16,,,
29590,18043,11547,15,,,
31883,11149,20734,13,,,
31778,497,31281,9,,,
31934,29364,2570,23,,,
35591,27883,7708,10,,,
31341,26912,4429,8,,,
32846,20209,12637,17,,,
33957,9001,24956,7,,,
26004,13872,12132,17,,,
23780,11374,12406,21,,,
27346,12728,14618,7,,,
32327,17971,14356,11,,,
27015,9690,17325,15,,,
37600,9145,28455,9,,,
26120,3639,22481,13,,,
27386,16264,11122,16,,,
34776,15629,19147,14,,,
27418,23003,4415,16,,,
27241,2044,25197,12,,,
34377,10068,24309,17,,,
23346,940,22406,15,,,
33789,2253,31536,10,,,
24495,4576,19919,13,,,
23679,16777,6902,6,,,
30105,13467,16638,14,,,
34027,18141,15886,10,,,
33364,10225,23139,8,,,
25702,2506,23196,12,,,
27503,10108,17395,9,,,
30838,11502,19336,14,,,
21543,10597,10946,5,,,
33718,14307,19411,23,,,
28132,12951,15181,13,,,
24349,20535,3814,20,,,
29883,26046,3837,7,,,
25611,25145,466,11,,,
25824,742,25082,7,,,
31504,7296,24208,19,,,
25898,18678,7220,6,,,
27222,10122,17100,7,,,
35695,1353,34342,11,,,
32320,9652,22668,12,,,
27438,20165,7273,26,,,
27814,10351,17463,12,,,
29765,19045,10720,19,,,
25735,8551,17184,9,,,
24211,15267,8944,11,,,
36142,11840,24302,8,,,
29519,23457,6062,16,,,
23454,2156,21298,14,,,
31689,9308,22381,4,,,
31506,2051,29455,10,,,
29925,10457,19468,10,,,
30319,10907,19412,17,,,
26451,7911,18540,9,,,
33379,12512,20867,19,,,
37824,2056,35768,19,,,
34541,3780,30761,9,,,
27256,19641,7615,18,,,
37146,12726,24420,8,,,
25400,16158,9242,7,,,
33949,7688,26261,19,,,
30248,23721,6527,15,,,
29268,26473,2795,5,,,
25255,71,25184,18,,,
35519,11577,23942,17,,,
26614,20496,6118,16,,,
29269,12822,16447,9,,,
25636,23463,2173,13,,,
23726,4106,19620,18,,,
29442,2196,27246,8,,,
25680,5683,19997,15,,,
29333,11483,17850,10,,,
21686,4604,17082,18,,,
27741,18133,9608,13,,,
31719,21304,10415,11,,,
26250,9731,16519,11,,,
23714,21031,2683,10,,,
31553,7369,24184,11,,,
27758,12967,14791,14,,,
25531,7237,18294,11,,,
35459,17224,18235,22,,,
25266,16958,8308,11,,,
27682,1256,26426,8,,,
33947,7992,25955,14,,,
33412,17501,15911,7,,,
35081,16756,18325,11,,,
28021,23455,4566,12,,,
33835,2452,31383,13,,,
25226,22175,3051,13,,,
33367,27825,5542,15,,,
29845,19388,10457,14,,,
31399,14555,16844,13,,,
27516,26763,753,3,,,
34103,13761,20342,10,,,
25992,14983,11009,18,,,
37554,23665,13889,10,,,
33278,18698,14580,11,,,
30410,29377,1033,24,,,
22023,8846,13177,14,,,
27343,25131,2212,15,,,
32045,219,31826,21,,,
34068,9370,24698,10,,,
29706,14036,15670,9,,,
29684,59,29625,8,,,
27504,23429,4075,13,,,
27449,6667,20782,15,,,
29929,21942,7987,18,,,
27525,3233,24292,19,,,
33755,6732,27023,18,,,
38072,18556,19516,10,,,
23356,13173,10183,10,,,
29227,10324,18903,16,,,
20844,4182,16662,15,,,
26295,8147,18148,13,,,
27039,2850,24189,14,,,
15731,3767,11964,10,,,
30083,1261,28822,13,,,
21614,16218,5396,9,,,
31769,3552,28217,6,,,
29324,11484,17840,13,,,
23110,17707,5403,11,,,
31265,23161,8104,11,,,
33767,21210,12557,12,,,
29968,24086,5882,16,,,
25970,20923,5047,21,,,
35428,12111,23317,9,,,
31665,5072,26593,13,,,
29533,16314,13219,11,,,
31942,21056,10886,6,,,
31837,8493,23344,9,,,
28987,3177,25810,11,,,
25140,13744,11396,14,,,
33206,4816,28390,17,,,
33223,2879,30344,17,,,
31616,5861,25755,11,,,
27797,8587,19210,18,,,
35241,18220,17021,10,,,
31319,27110,4209,5,,,
32974,22714,10260,15,,,
31393,3541,27852,18,,,
31352,18359,12993,13,,,
31032,21445,9587,10,,,
34500,25506,8994,16,,,
36019,14817,21202,8,,,
29441,27893,1548,19,,,
41961,30831,11130,18,,,
27840,21870,5970,12,,,
34858,24798,10060,5,,,
27562,9019,18543,14,,,
26177,17651,8526,23,,,
25668,8103,17565,23,,,
33179,12390,20789,26,,,
21506,12970,8536,12,,,
27034,3504,23530,6,,,
28728,22705,6023,5,,,
30504,2671,27833,17,,,
27902,25868,2034,16,,,
33357,4549,28808,11,,,
35555,24203,11352,10,,,
35173,871,34302,15,,,
31110,26425,4685,25,,,
15399,2577,12822,15,,,
21228,16387,4841,12,,,
27628,15620,12008,13,,,
25785,22838,2947,18,,,
38244,23833,14411,11,,,
33960,17369,16591,20,,,
35353,22402,12951,9,,,
31849,26851,4998,14,,,
31318,27969,3349,11,,,
23563,1972,21591,13,,,
29053,6359,22694,11,,,
25799,23435,2364,12,,,
25784,7808,17976,31,,,
30089,8051,22038,9,,,
23704,23185,519,11,,,
29997,24626,5371,6,,,
34212,20892,13320,5,,,
33618,32551,1067,14,,,
25980,53,25927,10,,,
27358,9281,18077,26,,,
24782,3442,21340,12,,,
23752,6113,17639,21,,,
19401,16459,2942,25,,,
30267,22606,7661,7,,,
27706,22647,5059,19,,,
33153,4873,28280,13,,,
32297,12613,19684,6,,,
31621,8154,23467,16,,,
27759,21275,6484,11,,,
25240,649,24591,8,,,
24416,5269,19147,17,,,
31466,29046,2420,11,,,
28300,26889,1411,9,,,
27643,27623,20,9,,,
34111,7703,26408,17,,,
27873,9054,18819,34,,,
29728,4133,25595,7,,,
29146,15125,14021,9,,,
29878,24906,4972,15,,,
21241,12233,9008,18,,,
31917,5942,25975,16,,,
25249,1925,23324,17,,,
23237,20853,2384,5,,,
29811,15673,14138,16,,,
36595,30892,5703,19,,,
33877,3441,30436,10,,,
27354,4849,22505,18,,,
31453,616,30837,21,,,
30124,21593,8531,15,,,
23935,22722,1213,10,,,
38043,27013,11030,24,,,
27111,1718,25393,4,,,
29404,17320,12084,19,,,
30714,25003,5711,13,,,
26203,13253,12950,20,,,
35243,2880,32363,6,,,
25415,18412,7003,18,,,
29680,4366,25314,10,,,
34173,28360,5813,17,,,
37787,1010,36777,17,,,
28380,17376,11004,14,,,
30937,22382,8555,16,,,
33542,6392,27150,16,,,
23951,4710,19241,22,,,
22241,18759,3482,8,,,
37954,5239,32715,5,,,
27384,12905,14479,17,,,
23445,21348,2097,12,,,
29489,16525,12964,8,,,
31762,29629,2133,15,,,
33284,15338,17946,13,,,
19940,2458,17482,12,,,
29911,9322,20589,10,,,
31939,17769,14170,21,,,
29880,7245,22635,13,,,
27661,3196,24465,7,,,
36243,6058,30185,11,,,
33160,31375,1785,10,,,
33481,32434,1047,12,,,
23992,19687,4305,18,,,
27575,17668,9907,12,,,
19554,6015,13539,6,,,
27851,13475,14376,15,,,
25773,13337,12436,19,,,
31261,14835,16426,12,,,
25070,7318,17752,6,,,
33359,20816,12543,12,,,
27847,17291,10556,31,,,
33085,11174,21911,11,,,
21611,17865,3746,15,,,
33398,24007,9391,5,,,
27852,15645,12207,12,,,
21948,5153,16795,7,,,
35576,21436,14140,17,,,
35825,10559,25266,9,,,
27569,10479,17090,8,,,
31987,10271,21716,15,,,
27825,17710,10115,10,,,
28027,12205,15822,23,,,
37947,8385,29562,3,,,
30282,5792,24490,9,,,
27049,11847,15202,14,,,
33830,24788,9042,11,,,
26146,25961,185,14,,,
33357,14466,18891,22,,,
29593,28488,1105,17,,,
21585,9006,12579,17,,,
32376,8071,24305,9,,,
30163,2626,27537,14,,,
33782,20348,13434,12,,,
27405,16910,10495,20,,,
33773,22309,11464,17,,,
27586,6037,21549,10,,,
31184,8269,22915,7,,,
21850,20488,1362,11,,,
27890,25068,2822,9,,,
21678,14372,7306,20,,,
39617,17763,21854,23,,,
35310,21033,14277,8,,,
33638,28391,5247,19,,,
30188,1246,28942,15,,,
22823,4830,17993,9,,,
25147,19357,5790,19,,,
25439,21010,4429,19,,,
25696,4583,21113,9,,,
27590,12624,14966,21,,,
27822,24743,3079,23,,,
27448,12835,14613,14,,,
27619,11823,15796,11,,,
35155,2765,32390,21,,,
38134,29196,8938,11,,,
33749,7875,25874,6,,,
32231,2243,29988,23,,,
33442,22975,10467,14,,,
22064,16964,5100,13,,,
29563,11960,17603,8,,,
33482,6504,26978,4,,,
30090,12365,17725,5,,,
32183,5409,26774,10,,,
29634,3315,26319,26,,,
21381,12248,9133,9,,,
29712,23847,5865,16,,,
23730,20945,2785,18,,,
32043,22038,10005,12,,,
31445,1462,29983,16,,,
29715,9373,20342,18,,,
36307,12224,24083,24,,,
27858,27090,768,15,,,
25712,21463,4249,19,,,
32856,18039,14817,15,,,
29851,21342,8509,11,,,
33545,15159,18386,24,,,
27307,2886,24421,17,,,
28558,26294,2264,7,,,
37314,17899,19415,18,,,
24780,3080,21700,13,,,
29432,24404,5028,15,,,
31988,13071,18917,12,,,
23952,12223,11729,5,,,
31284,25946,5338,14,,,
29535,20450,9085,13,,,
33390,13678,19712,7,,,
29800,16726,13074,26,,,
23725,14848,8877,15,,,
33613,11725,21888,9,,,
17344,1977,15367,21,,,
32083,5520,26563,13,,,
33955,16442,17513,11,,,
27019,9139,17880,13,,,
25785,17198,8587,14,,,
29730,14013,15717,17,,,
37354,36045,1309,7,,,
27577,2580,24997,18,,,
28997,19583,9414,11,,,
31116,19876,11240,20,,,
31423,18876,12547,9,,,
25602,10793,14809,16,,,
23302,14496,8806,13,,,
31983,24925,7058,20,,,
32115,15555,16560,17,,,
33479,30940,2539,8,,,
26065,10463,15602,8,,,
30251,14881,15370,8,,,
25835,2836,22999,12,,,
27757,5812,21945,16,,,
33024,31553,1471,10,,,
37804,32475,5329,11,,,
30126,2061,28065,6,,,
25917,17100,8817,19,,,
28924,13021,15903,7,,,
33403,15941,17462,17,,,
31873,1744,30129,8,,,
27663,6400,21263,19,,,
29555,20534,9021,17,,,
33774,9830,23944,19,,,
29796,26908,2888,19,,,
31731,10149,21582,14,,,
33710,6396,27314,14,,,
21822,19854,1968,6,,,
25970,17602,8368,17,,,
25454,14957,10497,17,,,
31850,24155,7695,8,,,
23469,1710,21759,7,,,
29606,26791,2815,10,,,
29306,14202,15104,12,,,
19547,13354,6193,18,,,
29609,17343,12266,9,,,
31606,21376,10230,12,,,
26278,1919,24359,12,,,
25558,12368,13190,9,,,
30726,16185,14541,9,,,
29390,14598,14792,11,,,
35805,592,35213,7,,,
25820,15669,10151,16,,,
35712,18472,17240,12,,,
31940,25091,6849,5,,,
27910,5204,22706,10,,,
35727,26807,8920,15,,,
35861,35532,329,9,,,
32809,5026,27783,13,,,
27690,1966,25724,17,,,
34384,16012,18372,13,,,
34229,26754,7475,13,,,
30136,22831,7305,8,,,
29728,23498,6230,13,,,
31207,7741,23466,12,,,
23811,321,23490,15,,,
25440,18265,7175,13,,,
28022,16969,11053,17,,,
28484,21537,6947,14,,,
34509,31493,3016,25,,,
31495,10767,20728,7,,,
29667,21482,8185,11,,,
37340,28604,8736,17,,,
27847,21822,6025,8,,,
21410,8628,12782,20,,,
25997,14657,11340,20,,,
27450,6480,20970,4,,,
29476,4022,25454,20,,,
28342,20865,7477,15,,,
35725,33131,2594,12,,,
35404,13438,21966,9,,,
32825,6981,25844,10,,,
37628,21082,16546,14,,,
27873,24243,3630,13,,,
29732,22512,7220,15,,,
35921,19781,16140,8,,,
31838,27621,4217,14,,,
27936,26317,1619,16,,,
31779,26683,5096,10,,,
31195,2128,29067,11,,,
33465,2115,31350,16,,,
35616,27515,8101,7,,,
37433,25183,12250,15,,,
27818,13725,14093,11,,,
33652,18412,15240,5,,,
29341,27561,1780,7,,,
35663,16796,18867,12,,,
25414,20779,4635,10,,,
31743,6370,25373,11,,,
23891,4198,19693,8,,,
30168,27854,2314,23,,,
29761,6614,23147,22,,,
37803,23872,13931,9,,,
25619,11321,14298,17,,,
31655,27819,3836,19,,,
23561,2638,20923,16,,,
27707,24530,3177,15,,,
33150,16249,16901,16,,,
31313,1312,30001,25,,,
35789,12449,23340,5,,,
37497,18743,18754,22,,,
19504,7967,11537,23,,,
33567,18918,14649,17,,,
29191,15628,13563,16,,,
24848,4004,20844,17,,,
33016,18349,14667,18,,,
27873,1525,26348,7,,,
35728,13637,22091,16,,,
31111,24587,6524,13,,,
31952,1949,30003,11,,,
27168,9999,17169,16,,,
33762,24452,9310,20,,,
29271,10695,18576,10,,,
30144,27179,2965,15,,,
32066,9896,22170,8,,,
29847,23863,5984,15,,,
31670,641,31029,15,,,
34057,17798,16259,13,,,
29635,28261,1374,17,,,
33127,7313,25814,7,,,
30633,8102,22531,10,,,
26108,20180,5928,21,,,
33200,16185,17015,13,,,
27037,7447,19590,5,,,
32522,14967,17555,17,,,
33544,30522,3022,6,,,
29292,23192,6100,12,,,
33011,23334,9677,16,,,
29503,20382,9121,18,,,
30920,15809,15111,9,,,
31944,13257,18687,15,,,
23867,22253,1614,21,,,
32363,27892,4471,17,,,
25623,22837,2786,8,,,
27328,7899,19429,18,,,
25977,16042,9935,9,,,
21955,8029,13926,3,,,
25098,11054,14044,5,,,
25757,22418,3339,10,,,
33196,13243,19953,5,,,
35304,7026,28278,20,,,
21489,2063,19426,9,,,
26053,10893,15160,10,,,
29121,3185,25936,14,,,
27628,1215,26413,15,,,
25860,1283,24577,7,,,
31805,5671,26134,12,,,
21857,9693,12164,14,,,
21469,8861,12608,17,,,
29111,26611,2500,9,,,
32196,23179,9017,15,,,
23781,10576,13205,13,,,
37827,24254,13573,3,,,
21991,2206,19785,22,,,
21819,8458,13361,22,,,
31269,28132,3137,14,,,
27673,17477,10196,14,,,
24200,3997,20203,6,,,
31948,556,31392,14,,,
21781,6394,15387,8,,,
29586,8552,21034,8,,,
29478,29134,344,14,,,
37103,8999,28104,12,,,
24143,2892,21251,18,,,
25357,21189,4168,17,,,
29570,4895,24675,18,,,
26182,15408,10774,15,,,
23945,19860,4085,9,,,
26836,7808,19028,11,,,
29785,4410,25375,8,,,
26325,11991,14334,7,,,
25803,22190,3613,7,,,
27961,49,27912,8,,,
35517,27871,7646,16,,,
25903,23183,2720,22,,,
25700,10900,14800,9,,,
19235,4885,14350,15,,,
30004,4982,25022,11,,,
29615,12590,17025,25,,,
26209,21316,4893,17,,,
31853,14219,17634,13,,,
25118,9934,15184,21,,,
35271,22113,13158,11,,,
29493,9568,19925,20,,,
27423,17719,9704,9,,,
21508,2009,19499,19,,,
30169,27551,2618,15,,,
28149,20747,7402,10,,,
35693,20917,14776,7,,,
32065,7286,24779,20,,,
25409,22384,3025,21,,,
31882,13821,18061,3,,,
25498,14067,11431,9,,,
31681,179,31502,15,,,
33597,12821,20776,15,,,
27180,15261,11919,12,,,
25499,17188,8311,14,,,
31591,12334,19257,21,,,
33745,21251,12494,10,,,
33029,16146,16883,16,,,
34292,30368,3924,12,,,
33392,30107,3285,13,,,
25920,22913,3007,21,,,
27356,26241,1115,14,,,
27589,5836,21753,20,,,
28802,23473,5329,16,,,
27376,25754,1622,12,,,
27616,14980,12636,14,,,
31558,13202,18356,19,,,
31982,29301,2681,11,,,
31688,5776,25912,22,,,
29777,28838,939,25,,,
29256,3328,25928,6,,,
33325,12759,20566,7,,,
27044,20304,6740,14,,,
31021,25632,5389,12,,,
35497,34902,595,8,,,
31346,25518,5828,15,,,
27837,30,27807,5,,,
32887,1158,31729,12,,,
30627,11655,18972,9,,,
29744,23158,6586,26,,,
27759,3431,24328,9,,,
20669,2202,18467,4,,,
34074,34020,54,12,,,
30174,4765,25409,14,,,
26190,6827,19363,14,,,
31203,15387,15816,11,,,
37734,27050,10684,14,,,
27326,19340,7986,16,,,
33397,983,32414,25,,,
24150,18769,5381,6,,,
31585,31281,304,15,,,
32874,32204,670,12,,,
32005,10466,21539,6,,,
33408,6061,27347,9,,,
33543,22939,10604,13,,,
31386,23779,7607,9,,,
29868,5337,24531,13,,,
32105,19781,12324,5,,,
32409,12390,20019,30,,,
29618,10313,19305,17,,,
29685,12952,16733,6,,,
27558,11252,16306,5,,,
36180,29033,7147,18,,,
34048,33249,799,21,,,
31338,5781,25557,14,,,
34311,22846,11465,15,,,
32645,26579,6066,13,,,
19842,12742,7100,13,,,
29050,8354,20696,13,,,
27512,2943,24569,20,,,
27626,20677,6949,21,,,
21756,11866,9890,5,,,
27865,3938,23927,9,,,
23831,3702,20129,10,,,
31689,23849,7840,18,,,
29467,12714,16753,8,,,
30979,2243,28736,11,,,
26904,465,26439,18,,,
31187,6527,24660,18,,,
33346,11353,21993,17,,,
37847,1700,36147,15,,,
33318,7140,26178,27,,,
24996,8933,16063,24,,,
35714,868,34846,20,,,
27617,16261,11356,13,,,
29683,24594,5089,25,,,
29862,12148,17714,17,,,
33967,30640,3327,25,,,
27975,11195,16780,19,,,
31478,28145,3333,9,,,
33793,13308,20485,4,,,
28862,9825,19037,16,,,
31960,31276,684,25,,,
23083,8456,14627,5,,,
32011,16984,15027,16,,,
36153,11438,24715,9,,,
31713,24414,7299,13,,,
29748,25214,4534,13,,,
27189,20849,6340,14,,,
32018,13881,18137,19,,,
35465,10884,24581,21,,,
27682,21168,6514,18,,,
31677,15896,15781,14,,,
23772,15805,7967,13,,,
23826,22204,1622,16,,,
34615,30151,4464,20,,,
35249,17275,17974,23,,,
31458,12070,19388,14,,,
31540,26126,5414,9,,,
25481,15314,10167,16,,,
25387,16097,9290,9,,,
29414,23920,5494,8,,,
31873,7854,24019,14,,,
33786,12368,21418,16,,,
31227,12653,18574,11,,,
23391,6535,16856,13,,,
26970,22791,4179,10,,,
29328,6834,22494,16,,,
25739,4723,21016,9,,,
35197,20086,15111,13,,,
33624,26982,6642,20,,,
28377,477,27900,10,,,
29166,27037,2129,8,,,
31493,22273,9220,11,,,
26109,10241,15868,14,,,
34433,31151,3282,26,,,
33565,40,33525,17,,,
33438,32819,619,5,,,
30193,20933,9260,20,,,
31622,2766,28856,19,,,
25110,24371,739,11,,,
33965,15530,18435,11,,,
29208,2167,27041,14,,,
29656,11854,17802,14,,,
27758,11285,16473,11,,,
29982,10519,19463,8,,,
27777,25837,1940,19,,,
31494,16346,15148,11,,,
33904,18722,15182,15,,,
25713,1059,24654,19,,,
33679,140,33539,12,,,
30212,5499,24713,15,,,
29806,20616,9190,11,,,
31407,19024,12383,16,,,
27991,22226,5765,9,,,
36534,31396,5138,20,,,
37755,17192,20563,17,,,
26293,16502,9791,20,,,
32888,12957,19931,10,,,
27516,21189,6327,13,,,
33546,28340,5206,15,,,
27503,25859,1644,4,,,
32926,6594,26332,16,,,
33574,15060,18514,3,,,
29187,17806,11381,4,,,
32885,28252,4633,14,,,
29284,17815,11469,16,,,
25089,22625,2464,6,,,
31458,12357,19101,14,,,
28000,2734,25266,11,,,
34256,5724,28532,15,,,
34594,432,34162,16,,,
34060,15760,18300,18,,,
31217,12914,18303,7,,,
35398,9767,25631,10,,,
31106,5192,25914,7,,,
29974,9869,20105,16,,,
36395,15815,20580,6,,,
32961,17039,15922,11,,,
25683,10100,15583,15,,,
35741,24094,11647,20,,,
32383,24129,8254,8,,,
25401,7106,18295,9,,,
29379,5951,23428,14,,,
29419,26375,3044,21,,,
33093,24281,8812,20,,,
25758,12155,13603,5,,,
23725,16062,7663,11,,,
29370,6851,22519,14,,,
31202,18301,12901,13,,,
27217,685,26532,18,,,
32053,21190,10863,7,,,
24756,12959,11797,19,,,
31160,10471,20689,13,,,
29235,9859,19376,7,,,
33911,4502,29409,3,,,
31823,25894,5929,19,,,
37577,30321,7256,16,,,
31829,19846,11983,16,,,
29588,23823,5765,6,,,
32246,13641,18605,19,,,
34442,21595,12847,20,,,
31876,26272,5604,16,,,
26126,934,25192,20,,,
31827,28076,3751,12,,,
30981,22379,8602,15,,,
32792,4328,28464,27,,,
25561,7860,17701,19,,,
25647,1726,23921,19,,,
35848,28639,7209,19,,,
27408,21258,6150,14,,,
20009,12684,7325,19,,,
25361,12125,13236,20,,,
28012,15208,12804,15,,,
28037,21066,6971,9,,,
31164,24184,6980,21,,,
29309,20292,9017,15,,,
23121,20336,2785,14,,,
33987,8979,25008,18,,,
33290,27047,6243,19,,,
23011,3892,19119,18,,,
28056,6396,21660,11,,,
40356,9420,30936,23,,,
24696,16338,8358,10,,,
23248,20209,3039,13,,,
19572,2346,17226,19,,,
37930,22910,15020,14,,,
27646,22083,5563,6,,,
25965,14144,11821,28,,,
25578,14392,11186,19,,,
39777,26673,13104,11,,,
36667,29154,7513,14,,,
25064,18635,6429,20,,,
30210,10143,20067,21,,,
25655,18870,6785,17,,,
29374,171,29203,17,,,
27308,12953,14355,18,,,
27921,5047,22874,10,,,
31541,28282,3259,24,,,
30046,11166,18880,14,,,
35560,28897,6663,19,,,
29111,11538,17573,15,,,
25376,20273,5103,17,,,
29724,7523,22201,22,,,
25736,17672,8064,20,,,
32344,15101,17243,14,,,
31962,12743,19219,10,,,
39314,33018,6296,9,,,
27526,16926,10600,12,,,
36246,29121,7125,19,,,
29383,20900,8483,24,,,
33599,28247,5352,27,,,
37658,1838,35820,14,,,
28980,28656,324,26,,,
23629,11625,12004,11,,,
29435,24586,4849,17,,,
33336,29515,3821,19,,,
29215,20102,9113,16,,,
32749,4387,28362,15,,,
31470,17770,13700,13,,,
33002,11798,21204,7,,,
35811,3251,32560,14,,,
36822,12544,24278,16,,,
29812,11697,18115,14,,,
34882,13602,21280,16,,,
31616,28145,3471,15,,,
25380,4728,20652,19,,,
32051,978,31073,4,,,
31908,25964,5944,12,,,
25403,21464,3939,18,,,
29514,27059,2455,17,,,
32538,10105,22433,9,,,
30980,27750,3230,21,,,
25614,19851,5763,16,,,
35660,7595,28065,17,,,
38025,18394,19631,22,,,
20013,17463,2550,14,,,
25548,20819,4729,13,,,
33300,5807,27493,8,,,
31762,21958,9804,14,,,
23827,5797,18030,12,,,
29094,8476,20618,15,,,
33888,12275,21613,9,,,
31903,11150,20753,13,,,
31341,30948,393,17,,,
31074,19493,11581,9,,,
27106,22835,4271,11,,,
25556,20389,5167,22,,,
31707,19557,12150,14,,,
25590,9633,15957,11,,,
29479,17318,12161,10,,,
32150,25477,6673,10,,,
27376,7313,20063,3,,,
29506,79,29427,17,,,
28716,1550,27166,12,,,
34040,4987,29053,11,,,
31178,8941,22237,23,,,
29782,2343,27439,22,,,
27136,563,26573,9,,,
25818,20179,5639,14,,,
27546,9110,18436,18,,,
33469,31948,1521,21,,,
37967,34576,3391,6,,,
23556,13626,9930,13,,,
33654,22952,10702,15,,,
17338,12292,5046,9,,,
27136,19728,7408,15,,,
32615,199,32416,14,,,
32071,24439,7632,3,,,
31420,11597,19823,15,,,
28253,1381,26872,15,,,
29778,13568,16210,13,,,
32343,8912,23431,23,,,
26045,24983,1062,14,,,
27375,25300,2075,29,,,
17596,17196,400,20,,,
33337,5986,27351,6,,,
33216,4456,28760,11,,,
31505,16368,15137,9,,,
25889,4667,21222,13,,,
31744,1354,30390,11,,,
21219,17047,4172,14,,,
35579,1135,34444,9,,,
34070,621,33449,22,,,
30063,367,29696,11,,,
25925,9038,16887,8,,,
32159,14309,17850,9,,,
26341,835,25506,19,,,
39303,61,39242,18,,,
33649,26472,7177,17,,,
25561,8806,16755,10,,,
29421,12831,16590,8,,,
37232,21882,15350,31,,,
32395,24329,8066,12,,,
32345,8412,23933,19,,,
29572,22775,6797,8,,,
31719,7758,23961,12,,,
27825,15128,12697,13,,,
28392,7883,20509,11,,,
27982,8542,19440,13,,,
27395,6949,20446,9,,,
31613,3494,28119,9,,,
32039,9251,22788,18,,,
31554,22812,8742,14,,,
24064,5167,18897,24,,,
24433,20205,4228,12,,,
37208,9234,27974,19,,,
26837,24863,1974,21,,,
35553,31740,3813,22,,,
22925,1878,21047,20,,,
31889,24672,7217,26,,,
27877,21653,6224,4,,,
31992,8858,23134,24,,,
39122,25962,13160,7,,,
23901,20484,3417,15,,,
32805,19910,12895,21,,,
24576,16901,7675,11,,,
32066,24382,7684,9,,,
38208,31077,7131,9,,,
29254,17783,11471,24,,,
31777,49,31728,7,,,
21130,3902,17228,9,,,
31738,18609,13129,10,,,
40274,15502,24772,7,,,
23122,14946,8176,20,,,
34387,1177,33210,13,,,
27121,2222,24899,13,,,
23494,16577,6917,14,,,
31828,8090,23738,14,,,
23442,4113,19329,13,,,
29905,5364,24541,12,,,
37530,10494,27036,21,,,
32411,18363,14048,13,,,
25609,221,25388,8,,,
30120,24250,5870,17,,,
29818,6557,23261,11,,,
27479,15437,12042,8,,,
30741,2127,28614,24,,,
30188,9430,20758,15,,,
33234,17106,16128,16,,,
25663,13322,12341,13,,,
27645,3205,24440,11,,,
30404,27943,2461,14,,,
25703,8475,17228,8,,,
33861,29282,4579,7,,,
29975,7110,22865,12,,,
28452,15749,12703,13,,,
35678,7518,28160,14,,,
37168,15784,21384,13,,,
25688,9006,16682,10,,,
33894,18513,15381,16,,,
29434,4514,24920,11,,,
30570,16848,13722,17,,,
31802,25213,6589,18,,,
33115,21623,11492,22,,,
29810,21140,8670,17,,,
25756,21490,4266,7,,,
25969,8999,16970,10,,,
29844,12159,17685,20,,,
29704,18659,11045,9,,,
30804,29306,1498,17,,,
26116,21555,4561,22,,,
25421,5810,19611,11,,,
27761,20768,6993,11,,,
24965,23653,1312,14,,,
28244,2476,25768,11,,,
21801,13452,8349,8,,,
29432,9712,19720,11,,,
21910,4712,17198,9,,,
29220,26130,3090,19,,,
31508,17036,14472,13,,,
22005,1691,20314,11,,,
29450,10748,18702,18,,,
25539,1598,23941,15,,,
29221,17253,11968,14,,,
27264,24924,2340,19,,,
35113,16583,18530,23,,,
31505,19295,12210,10,,,
31804,19603,12201,13,,,
33127,10719,22408,14,,,
24248,1814,22434,15,,,
31317,29941,1376,11,,,
25932,2443,23489,11,,,
35310,11239,24071,11,,,
31288,28809,2479,6,,,
33532,6721,26811,13,,,
29525,6770,22755,10,,,
31398,6118,25280,13,,,
23351,17734,5617,22,,,
27060,16113,10947,10,,,
38002,37505,497,9,,,
21750,6522,15228,11,,,
29717,10169,19548,12,,,
23987,19278,4709,8,,,
31818,22019,9799,14,,,
31361,28605,2756,12,,,
26906,780,26126,14,,,
30296,28230,2066,15,,,
24483,6209,18274,15,,,
31371,8132,23239,19,,,
31900,4970,26930,8,,,
36557,5607,30950,10,,,
32170,1406,30764,16,,,
31852,6285,25567,8,,,
34910,29640,5270,13,,,
24353,18892,5461,14,,,
33865,15588,18277,15,,,
24093,3464,20629,15,,,
23659,20965,2694,9,,,
29436,2226,27210,12,,,
29044,20826,8218,12,,,
29601,18792,10809,6,,,
27092,11548,15544,12,,,
27704,12973,14731,22,,,
32106,9708,22398,16,,,
37305,20698,16607,15,,,
28839,23784,5055,12,,,
31585,13489,18096,10,,,
21175,18734,2441,7,,,
27581,21790,5791,12,,,
31343,11130,20213,12,,,
33216,20416,12800,15,,,
25086,7523,17563,11,,,
23933,2747,21186,9,,,
31929,13225,18704,16,,,
25799,16369,9430,8,,,
27981,22621,5360,13,,,
36166,19732,16434,12,,,
21336,6477,14859,13,,,
33620,24058,9562,11,,,
30337,18594,11743,18,,,
25058,21863,3195,4,,,
22391,1365,21026,5,,,
21926,12309,9617,11,,,
27425,16501,10924,13,,,
28922,14670,14252,11,,,
31444,23040,8404,11,,,
31974,23781,8193,11,,,
33230,3944,29286,17,,,
29440,16665,12775,12,,,
38165,36348,1817,23,,,
33436,21680,11756,10,,,
37687,8370,29317,16,,,
30983,21383,9600,8,,,
27695,14195,13500,22,,,
25889,4639,21250,10,,,
29500,28433,1067,10,,,
39345,34879,4466,11,,,
25939,20398,5541,14,,,
27776,25778,1998,5,,,
26221,12049,14172,15,,,
29013,22756,6257,19,,,
30353,23529,6824,11,,,
27949,3207,24742,13,,,
29214,22842,6372,12,,,
33471,31358,2113,30,,,
33546,2274,31272,7,,,
22150,11929,10221,17,,,
35044,27358,7686,20,,,
37326,14385,22941,14,,,
31212,206,31006,5,,,
29983,20153,9830,8,,,
27487,694,26793,22,,,
19755,17616,2139,12,,,
29975,16938,13037,15,,,
39601,29553,10048,14,,,
29257,23923,5334,14,,,
33326,12016,21310,17,,,
30033,20290,9743,4,,,
29971,14038,15933,16,,,
34024,3959,30065,6,,,
29714,2012,27702,12,,,
33476,14879,18597,11,,,
31209,25173,6036,20,,,
26425,244,26181,13,,,
22968,17130,5838,12,,,
27434,11758,15676,20,,,
27671,14119,13552,16,,,
27667,5870,21797,18,,,
25700,5143,20557,13,,,
33176,14741,18435,24,,,
19839,11278,8561,15,,,
31684,19247,12437,15,,,
19524,9448,10076,9,,,
33439,7269,26170,8,,,
31262,19510,11752,16,,,
29448,14792,14656,21,,,
31541,30062,1479,5,,,
27157,16837,10320,22,,,
21644,17786,3858,12,,,
27462,17591,9871,9,,,
28013,21456,6557,16,,,
27329,21213,6116,9,,,
35409,20165,15244,17,,,
24768,8370,16398,9,,,
35041,19090,15951,3,,,
29539,1870,27669,15,,,
24847,6998,17849,18,,,
32026,23000,9026,12,,,
29254,10935,18319,14,,,
33130,20683,12447,13,,,
27502,13852,13650,8,,,
31746,21541,10205,8,,,
27237,20389,6848,11,,,
33912,16021,17891,26,,,
23427,6504,16923,16,,,
27299,10409,16890,20,,,
21462,12280,9182,9,,,
25300,6588,18712,9,,,
27809,20570,7239,21,,,
27479,20944,6535,11,,,
35567,3081,32486,16,,,
36269,30577,5692,11,,,
25157,3061,22096,13,,,
29722,3326,26396,12,,,
19185,15521,3664,17,,,
25664,24993,671,17,,,
25341,11289,14052,18,,,
29817,9950,19867,8,,,
27478,2909,24569,16,,,
29128,17049,12079,13,,,
27266,1392,25874,3,,,
23601,17977,5624,16,,,
31723,18783,12940,14,,,
25152,9907,15245,16,,,
32707,12279,20428,16,,,
30126,12135,17991,9,,,
33343,30724,2619,10,,,
27453,9307,18146,16,,,
31263,19542,11721,14,,,
33468,13525,19943,14,,,
33652,14635,19017,9,,,
31395,5422,25973,4,,,
25928,16654,9274,8,,,
25659,14198,11461,18,,,
29401,10320,19081,15,,,
23563,6090,17473,15,,,
33538,18996,14542,15,,,
33655,20752,12903,6,,,
33422,1245,32177,12,,,
31819,4044,27775,4,,,
37136,27055,10081,7,,,
25250,2350,22900,9,,,
27549,5213,22336,14,,,
30199,19346,10853,21,,,
39051,32340,6711,14,,,
29819,23292,6527,13,,,
29462,5995,23467,16,,,
39402,38234,1168,12,,,
35406,31060,4346,4,,,
29074,14073,15001,7,,,
29590,20561,9029,15,,,
30693,6741,23952,28,,,
33728,27997,5731,17,,,
31693,3919,27774,9,,,
26679,13381,13298,13,,,
19580,8110,11470,14,,,
25811,12762,13049,13,,,
34335,18199,16136,10,,,
35979,4791,31188,12,,,
32323,1573,30750,23,,,
25876,1477,24399,13,,,
33929,13046,20883,19,,,
25949,21282,4667,12,,,
33986,107,33879,15,,,
29717,9918,19799,18,,,
31885,15467,16418,9,,,
26207,11630,14577,22,,,
29152,21829,7323,6,,,
25351,24404,947,16,,,
36037,19955,16082,13,,,
33772,4554,29218,6,,,
33489,11006,22483,10,,,
31735,5335,26400,25,,,
31631,9190,22441,28,,,
21105,20399,706,19,,,
23642,3258,20384,12,,,
33200,1554,31646,17,,,
29151,18821,10330,5,,,
33851,33487,364,8,,,
35352,15078,20274,10,,,
30818,5750,25068,5,,,
29224,14885,14339,5,,,
27318,5031,22287,8,,,
33763,12,33751,15,,,
29610,12777,16833,15,,,
32574,22538,10036,9,,,
31820,9025,22795,13,,,
31493,7413,24080,13,,,
27427,17174,10253,21,,,
23511,17393,6118,17,,,
31473,26505,4968,13,,,
31477,20601,10876,9,,,
21386,14577,6809,15,,,
26327,8392,17935,5,,,
35410,203,35207,14,,,
35251,13208,22043,21,,,
37310,1,37309,20,,,
29672,28449,1223,13,,,
24953,12928,12025,16,,,
33468,16590,16878,7,,,
24065,10180,13885,21,,,
30334,22085,8249,10,,,
25721,20268,5453,15,,,
35887,31595,4292,10,,,
31520,12429,19091,11,,,
34453,3787,30666,11,,,
29152,1859,27293,15,,,
33733,16766,16967,13,,,
35514,31769,3745,8,,,
31524,4793,26731,20,,,
29696,895,28801,17,,,
29549,10490,19059,6,,,
26196,14058,12138,7,,,
38269,25537,12732,8,,,
31382,30521,861,17,,,
34260,2811,31449,19,,,
28868,24757,4111,11,,,
35579,13252,22327,26,,,
33132,2675,30457,16,,,
27360,22771,4589,4,,,
29520,11411,18109,20,,,
25534,8612,16922,6,,,
22153,10973,11180,27,,,
21851,2209,19642,31,,,
31365,15552,15813,21,,,
21544,10291,11253,15,,,
35361,16653,18708,23,,,
27889,17979,9910,13,,,
39161,19838,19323,13,,,
31735,9790,21945,11,,,
26293,7902,18391,17,,,
33121,7381,25740,7,,,
27991,21819,6172,13,,,
25787,19534,6253,9,,,
21385,8945,12440,16,,,
31146,3194,27952,12,,,
21384,997,20387,6,,,
25799,21276,4523,14,,,
29391,13956,15435,6,,,
35659,31563,4096,16,,,
29109,20099,9010,11,,,
29914,23982,5932,3,,,
35503,2230,33273,26,,,
19493,16869,2624,22,,,
30978,26117,4861,10,,,
35468,1298,34170,16,,,
23798,6164,17634,14,,,
29610,7672,21938,20,,,
22537,4995,17542,8,,,
35591,31495,4096,14,,,
31257,24076,7181,18,,,
31994,16328,15666,6,,,
29650,6015,23635,17,,,
27312,11680,15632,7,,,
33564,5794,27770,8,,,
21607,12027,9580,18,,,
33860,26277,7583,20,,,
27892,13859,14033,28,,,
24151,2005,22146,14,,,
27920,3003,24917,10,,,
27382,21660,5722,17,,,
34001,11706,22295,15,,,
27826,1145,26681,9,,,
26987,24271,2716,22,,,
31484,22474,9010,16,,,
32275,7129,25146,13,,,
33819,3163,30656,22,,,
24445,20769,3676,9,,,
31496,29819,1677,10,,,
29575,1624,27951,13,,,
25304,23088,2216,18,,,
35417,16219,19198,25,,,
34931,6010,28921,14,,,
27897,2690,25207,12,,,
27294,22267,5027,6,,,
29911,92,29819,20,,,
24179,2993,21186,13,,,
26164,6916,19248,21,,,
30007,29060,947,16,,,
29215,20067,9148,5,,,
33462,26289,7173,15,,,
32383,2998,29385,16,,,
27555,12808,14747,10,,,
29432,12537,16895,16,,,
25356,12697,12659,6,,,
27099,19467,7632,15,,,
35309,10336,24973,8,,,
27852,5315,22537,13,,,
31123,12165,18958,17,,,
29071,12135,16936,10,,,
23749,7859,15890,11,,,
35321,3505,31816,5,,,
29891,25499,4392,8,,,
37049,36315,734,12,,,
19150,3330,15820,7,,,
29253,1428,27825,15,,,
31169,30950,219,12,,,
27642,14580,13062,16,,,
31848,16531,15317,7,,,
26621,11612,15009,17,,,
28762,22953,5809,18,,,
27639,24517,3122,15,,,
33846,16051,17795,17,,,
31335,17391,13944,5,,,
25991,8822,17169,19,,,
33845,743,33102,16,,,
35558,31162,4396,19,,,
29314,8293,21021,16,,,
23350,23166,184,17,,,
31473,29967,1506,8,,,
27272,20229,7043,15,,,
30102,21480,8622,12,,,
23578,4901,18677,8,,,
29643,23542,6101,13,,,
33449,27698,5751,12,,,
32046,13695,18351,21,,,
34860,29327,5533,18,,,
31742,19675,12067,24,,,
25301,14572,10729,14,,,
27318,5496,21822,21,,,
29404,15697,13707,13,,,
25939,5396,20543,11,,,
36795,31598,5197,11,,,
35627,6490,29137,25,,,
33368,19091,14277,9,,,
27589,2344,25245,14,,,
30591,3330,27261,12,,,
27666,11490,16176,8,,,
21625,12486,9139,17,,,
31824,18913,12911,14,,,
31857,31336,521,21,,,
30095,7311,22784,11,,,
31327,20765,10562,11,,,
23389,8606,14783,11,,,
20320,249,20071,7,,,
23498,5556,17942,16,,,
27052,25742,1310,11,,,
23825,3013,20812,8,,,
23582,4210,19372,8,,,
27978,9733,18245,18,,,
31010,7534,23476,9,,,
34081,32544,1537,17,,,
25177,19983,5194,4,,,
31917,28887,3030,15,,,
32005,14628,17377,12,,,
33935,29185,4750,6,,,
35533,32984,2549,14,,,
27107,7105,20002,15,,,
27677,17807,9870,11,,,
27052,4076,22976,20,,,
25154,7903,17251,15,,,
32527,14545,17982,17,,,
32141,3232,28909,13,,,
36041,4489,31552,17,,,
24157,6327,17830,16,,,
27213,24210,3003,21,,,
24640,15838,8802,15,,,
31026,17581,13445,14,,,
37255,18430,18825,7,,,
33406,22507,10899,18,,,
27900,6648,21252,15,,,
29608,66,29542,21,,,
28808,4208,24600,6,,,
31211,19903,11308,12,,,
31948,10134,21814,16,,,
33962,33776,186,25,,,
31055,27824,3231,10,,,
27672,11567,16105,4,,,
25099,19271,5828,17,,,
31610,8230,23380,17,,,
27591,11109,16482,17,,,
29600,2325,27275,11,,,
29057,20437,8620,17,,,
27763,25361,2402,11,,,
37468,8857,28611,13,,,
27623,24225,3398,15,,,
33287,7524,25763,17,,,
29632,21686,7946,12,,,
25206,15435,9771,13,,,
33712,5335,28377,11,,,
33667,25743,7924,16,,,
30445,16640,13805,5,,,
29660,729,28931,12,,,
25736,10746,14990,10,,,
16961,6998,9963,8,,,
36344,29237,7107,24,,,
29050,6782,22268,22,,,
27314,18603,8711,9,,,
27349,21342,6007,23,,,
29564,6902,22662,12,,,
29652,17390,12262,17,,,
21885,19580,2305,14,,,
25882,12054,13828,16,,,
35728,12866,22862,10,,,
25862,16003,9859,23,,,
33766,29612,4154,11,,,
23643,13755,9888,9,,,
31594,25498,6096,13,,,
31740,906,30834,15,,,
36388,22081,14307,10,,,
27397,22577,4820,3,,,
26002,3954,22048,14,,,
29569,25312,4257,12,,,
36122,6617,29505,19,,,
30050,11694,18356,22,,,
31214,10615,20599,17,,,
28870,4014,24856,20,,,
25375,19380,5995,12,,,
33810,9511,24299,7,,,
25525,16522,9003,8,,,
39962,30216,9746,21,,,
35399,6771,28628,7,,,
30203,6345,23858,7,,,
32827,5396,27431,20,,,
31703,17993,13710,16,,,
29160,20959,8201,9,,,
23738,11500,12238,15,,,
31909,4507,27402,16,,,
25780,5984,19796,9,,,
28188,4385,23803,16,,,
32204,10925,21279,10,,,
32050,10629,21421,13,,,
29533,10365,19168,12,,,
27280,7984,19296,9,,,
23782,23464,318,14,,,
30016,24780,5236,11,,,
27896,2996,24900,11,,,
31459,1073,30386,13,,,
29216,3034,26182,6,,,
28125,596,27529,11,,,
31310,3838,27472,15,,,
25964,4690,21274,32,,,
21958,4697,17261,19,,,
30965,20242,10723,26,,,
33285,24117,9168,19,,,
26961,8124,18837,25,,,
35419,17890,17529,18,,,
31509,29349,2160,20,,,
32067,6760,25307,12,,,
34935,10060,24875,18,,,
33693,6654,27039,13,,,
25684,22732,2952,11,,,
32100,28013,4087,19,,,
34129,12050,22079,16,,,
24096,23451,645,12,,,
31923,2163,29760,9,,,
31952,2796,29156,5,,,
29815,9016,20799,16,,,
27802,23219,4583,24,,,
36477,10579,25898,10,,,
34428,19533,14895,11,,,
26163,19137,7026,12,,,
37416,12650,24766,15,,,
32756,26144,6612,9,,,
19756,5096,14660,14,,,
29256,26675,2581,11,,,
27725,19936,7789,9,,,
33731,4555,29176,18,,,
33842,7612,26230,13,,,
31558,1635,29923,16,,,
22069,7039,15030,20,,,
31623,29377,2246,6,,,
30640,27518,3122,3,,,
25539,5248,20291,15,,,
33516,23988,9528,14,,,
25307,16331,8976,12,,,
33648,11299,22349,12,,,
31649,2581,29068,11,,,
29750,15012,14738,14,,,
36765,24584,12181,15,,,
28638,16348,12290,11,,,
26770,5822,20948,7,,,
29435,10578,18857,21,,,
33564,21778,11786,9,,,
31277,15514,15763,17,,,
29551,16565,12986,18,,,
37197,18380,18817,12,,,
26266,17426,8840,13,,,
31472,4155,27317,7,,,
29711,27006,2705,5,,,
24229,21881,2348,14,,,
26776,22279,4497,23,,,
29522,12259,17263,13,,,
27982,3291,24691,19,,,
31314,7346,23968,10,,,
32097,20785,11312,12,,,
26345,6070,20275,26,,,
28983,11965,17018,18,,,
31393,20876,10517,10,,,
23425,11522,11903,7,,,
33384,20864,12520,17,,,
31436,11267,20169,11,,,
31952,28731,3221,9,,,
25885,5473,20412,9,,,
31177,17580,13597,16,,,
23582,3036,20546,12,,,
33605,2576,31029,9,,,
29536,5899,23637,13,,,
24038,6534,17504,16,,,
29970,22050,7920,23,,,
27842,26532,1310,18,,,
26026,2105,23921,17,,,
29455,20347,9108,17,,,
35323,13751,21572,18,,,
30096,13986,16110,13,,,
28375,16082,12293,19,,,
29867,20431,9436,11,,,
33111,6988,26123,15,,,
23551,22150,1401,17,,,
31827,15383,16444,5,,,
31118,29952,1166,16,,,
32732,22809,9923,22,,,
30250,6454,23796,19,,,
32089,352,31737,8,,,
27750,1302,26448,13,,,
34889,18584,16305,17,,,
25729,4429,21300,4,,,
23040,20026,3014,7,,,
25628,7955,17673,12,,,
25759,8692,17067,16,,,
28305,22275,6030,10,,,
23900,15575,8325,9,,,
38035,35744,2291,14,,,
25938,25206,732,18,,,
23225,17222,6003,30,,,
28154,8046,20108,6,,,
29436,2184,27252,10,,,
25538,5925,19613,11,,,
21858,8766,13092,17,,,
29444,452,28992,10,,,
21838,5300,16538,10,,,
29149,23462,5687,12,,,
29621,18090,11531,8,,,
34514,18695,15819,22,,,
29310,4753,24557,16,,,
29981,12987,16994,8,,,
29317,10105,19212,12,,,
31777,28749,3028,18,,,
29896,16697,13199,12,,,
29981,4777,25204,21,,,
37245,5770,31475,15,,,
33151,226,32925,17,,,
26659,2779,23880,11,,,
31535,7670,23865,7,,,
29027,21245,7782,17,,,
31253,21092,10161,15,,,
27425,10534,16891,10,,,
32237,16395,15842,7,,,
21309,1318,19991,23,,,
23666,21941,1725,12,,,
33102,21480,11622,21,,,
28090,23088,5002,15,,,
34063,30374,3689,17,,,
30940,28644,2296,11,,,
35707,10696,25011,9,,,
31783,6893,24890,10,,,
25124,9630,15494,26,,,
29068,24706,4362,7,,,
31498,14362,17136,8,,,
23244,14769,8475,12,,,
33595,7700,25895,5,,,
33323,9583,23740,11,,,
31247,4342,26905,11,,,
31731,21001,10730,13,,,
33592,22232,11360,13,,,
33726,5953,27773,18,,,
39873,29409,10464,13,,,
25773,8549,17224,14,,,
31247,25567,5680,12,,,
24811,443,24368,18,,,
31696,7083,24613,8,,,
23130,16127,7003,6,,,
30042,20895,9147,18,,,
27598,8856,18742,10,,,
23716,20266,3450,8,,,
26202,5927,20275,21,,,
29551,13528,16023,17,,,
27046,25705,1341,8,,,
25473,16268,9205,9,,,
35459,31526,3933,9,,,
29607,6021,23586,8,,,
30080,14855,15225,11,,,
31176,27569,3607,22,,,
24071,21475,2596,14,,,
32188,18790,13398,12,,,
31999,12525,19474,13,,,
34969,31321,3648,29,,,
27219,13728,13491,9,,,
33668,22393,11275,9,,,
33074,30847,2227,23,,,
27570,3459,24111,22,,,
33367,3799,29568,15,,,
31663,10272,21391,10,,,
39167,30035,9132,10,,,
37428,13679,23749,8,,,
25594,10718,14876,11,,,
35000,602,34398,20,,,
29629,10724,18905,10,,,
29671,20331,9340,20,,,
25898,22502,3396,10,,,
35666,26997,8669,14,,,
35672,7349,28323,3,,,
34807,15258,19549,7,,,
33546,1954,31592,4,,,
35330,558,34772,13,,,
33412,17520,15892,7,,,
32088,26822,5266,10,,,
33355,9830,23525,24,,,
27324,16144,11180,10,,,
27061,16331,10730,9,,,
31771,24475,7296,10,,,
35614,33763,1851,5,,,
31257,24276,6981,9,,,
33388,3594,29794,7,,,
26950,15137,11813,15,,,
33313,11947,21366,19,,,
32045,29652,2393,13,,,
38438,7249,31189,7,,,
27377,5331,22046,8,,,
32142,22034,10108,16,,,
27635,8849,18786,16,,,
31635,21616,10019,14,,,
37841,3841,34000,7,,,
31635,10640,20995,9,,,
25426,3325,22101,10,,,
34271,19371,14900,13,,,
31404,23574,7830,16,,,
27685,15484,12201,4,,,
33385,4807,28578,9,,,
21465,16205,5260,11,,,
19859,16580,3279,14,,,
21570,4424,17146,12,,,
33903,15522,18381,14,,,
27431,9021,18410,6,,,
35478,18652,16826,15,,,
27736,26924,812,15,,,
30780,5550,25230,12,,,
25944,1096,24848,23,,,
35566,15001,20565,7,,,
33737,33211,526,18,,,
28920,7634,21286,17,,,
29637,20747,8890,18,,,
31564,21013,10551,18,,,
33221,22997,10224,18,,,
19187,11998,7189,10,,,
33287,6618,26669,11,,,
25837,14664,11173,15,,,
31271,25721,5550,18,,,
33263,4005,29258,7,,,
25951,18662,7289,9,,,
19782,5662,14120,19,,,
31631,23635,7996,13,,,
40133,20704,19429,9,,,
29661,28556,1105,8,,,
29350,3698,25652,10,,,
31812,24933,6879,15,,,
30316,20630,9686,11,,,
31535,27642,3893,18,,,
25535,25407,128,11,,,
27560,15932,11628,5,,,
29437,4,29433,6,,,
35644,22127,13517,18,,,
29943,6345,23598,23,,,
31140,2432,28708,19,,,
23264,22813,451,15,,,
21178,19286,1892,11,,,
24090,9328,14762,15,,,
23463,11831,11632,10,,,
31168,27926,3242,31,,,
35819,15852,19967,6,,,
28071,19220,8851,9,,,
33635,25271,8364,27,,,
32665,25350,7315,12,,,
29704,1801,27903,26,,,
29543,24644,4899,13,,,
25692,20599,5093,13,,,
33375,2450,30925,15,,,
31197,10667,20530,14,,,
29901,26745,3156,8,,,
34180,26965,7215,9,,,
31149,5194,25955,13,,,
31292,28708,2584,15,,,
29878,13078,16800,20,,,
31745,7153,24592,23,,,
31637,13166,18471,20,,,
35385,31370,4015,17,,,
21741,21180,561,6,,,
27320,12647,14673,10,,,
27534,1146,26388,6,,,
31267,9536,21731,3,,,
27710,9073,18637,16,,,
21558,926,20632,10,,,
32120,13899,18221,18,,,
25414,21046,4368,14,,,
28105,10714,17391,6,,,
19846,10627,9219,8,,,
23993,8034,15959,13,,,
33472,19457,14015,10,,,
37439,10508,26931,16,,,
41891,30768,11123,22,,,
33876,23283,10593,10,,,
30892,19035,11857,10,,,
25692,12946,12746,5,,,
30847,15632,15215,11,,,
31081,9564,21517,11,,,
27283,18924,8359,15,,,
27705,7656,20049,15,,,
27588,18765,8823,13,,,
27870,17120,10750,14,,,
31578,22531,9047,14,,,
25263,24652,611,8,,,
32435,26730,5705,11,,,
31456,29466,1990,18,,,
26017,10662,15355,12,,,
34642,27289,7353,16,,,
27747,23962,3785,5,,,
29794,1624,28170,12,,,
33484,18789,14695,11,,,
30868,23690,7178,21,,,
29960,5985,23975,16,,,
29317,15375,13942,13,,,
28823,4004,24819,6,,,
21940,12086,9854,6,,,
25675,22010,3665,16,,,
24407,8350,16057,16,,,
35568,31353,4215,20,,,
36235,10214,26021,17,,,
30286,10763,19523,11,,,
26096,15873,10223,11,,,
24022,9456,14566,27,,,
25330,566,24764,15,,,
35512,8677,26835,27,,,
29626,11050,18576,19,,,
21828,4643,17185,17,,,
24004,13555,10449,24,,,
26169,11434,14735,7,,,
31361,14746,16615,21,,,
28624,4471,24153,12,,,
36393,14451,21942,18,,,
24995,18274,6721,16,,,
33344,30249,3095,20,,,
39387,26692,12695,9,,,
31304,28327,2977,10,,,
31528,16069,15459,18,,,
31215,25318,5897,10,,,
29783,15407,14376,6,,,
29726,9240,20486,11,,,
27877,6395,21482,22,,,
40678,39853,825,21,,,
21282,3950,17332,22,,,
30986,18632,12354,11,,,
32977,11170,21807,13,,,
33299,5280,28019,12,,,
29206,9441,19765,9,,,
31788,506,31282,14,,,
32010,4059,27951,12,,,
28128,5142,22986,20,,,
27720,22682,5038,22,,,
24139,7745,16394,15,,,
37136,574,36562,19,,,
27833,12860,14973,17,,,
28372,8434,19938,7,,,
30114,10960,19154,13,,,
30284,29040,1244,10,,,
25205,11631,13574,14,,,
29868,4839,25029,10,,,
21606,13366,8240,8,,,
33609,16480,17129,14,,,
28117,112,28005,7,,,
33369,2910,30459,13,,,
36341,10625,25716,22,,,
26317,360,25957,5,,,
31944,8497,23447,23,,,
30420,23393,7027,17,,,
32463,8421,24042,20,,,
31740,16537,15203,15,,,
34106,16958,17148,15,,,
27856,15972,11884,20,,,
24211,12445,11766,11,,,
25935,6765,19170,12,,,
33667,25428,8239,11,,,
35110,19993,15117,18,,,
27994,14742,13252,13,,,
32055,28154,3901,14,,,
23104,17013,6091,14,,,
24153,15808,8345,26,,,
21886,4612,17274,20,,,
31392,29283,2109,8,,,
31627,193,31434,11,,,
31741,9046,22695,9,,,
31581,901,30680,9,,,
29310,22104,7206,4,,,
32269,16349,15920,12,,,
29643,7490,22153,23,,,
29531,27925,1606,23,,,
33126,25810,7316,15,,,
21988,6223,15765,30,,,
31429,2308,29121,18,,,
38033,4525,33508,10,,,
25213,9704,15509,7,,,
27552,25157,2395,19,,,
31691,19990,11701,28,,,
22015,7391,14624,10,,,
25183,21650,3533,12,,,
31642,13628,18014,20,,,
27492,16226,11266,16,,,
29047,6972,22075,8,,,
24211,2354,21857,14,,,
32031,21167,10864,10,,,
23527,8408,15119,11,,,
26243,21711,4532,15,,,
26045,1921,24124,14,,,
29416,4685,24731,9,,,
31628,69,31559,21,,,
29638,1743,27895,3,,,
30021,6240,23781,15,,,
23352,727,22625,15,,,
33437,18980,14457,18,,,
29783,3622,26161,11,,,
30676,22441,8235,5,,,
31363,28244,3119,15,,,
36283,499,35784,14,,,
29604,11434,18170,10,,,
29993,12032,17961,7,,,
27295,22444,4851,20,,,
27268,7060,20208,11,,,
30038,1011,29027,14,,,
27416,176,27240,29,,,
31429,22343,9086,15,,,
28040,195,27845,10,,,
29587,9334,20253,11,,,
25513,6032,19481,13,,,
33328,7838,25490,16,,,
33392,26936,6456,29,,,
29690,4623,25067,13,,,
34858,23011,11847,16,,,
36535,4219,32316,13,,,
25642,12516,13126,10,,,
25660,24183,1477,12,,,
33136,32351,785,5,,,
27995,10014,17981,17,,,
36007,31218,4789,14,,,
27484,22724,4760,20,,,
29850,12618,17232,21,,,
34316,23835,10481,4,,,
30163,1548,28615,15,,,
29389,4584,24805,20,,,
26864,9601,17263,13,,,
25053,16750,8303,17,,,
31946,5192,26754,28,,,
34232,34132,100,8,,,
27680,21318,6362,10,,,
33662,31053,2609,8,,,
29185,7025,22160,5,,,
30739,19220,11519,7,,,
27756,4384,23372,8,,,
31385,6238,25147,8,,,
33385,12456,20929,16,,,
25736,2385,23351,19,,,
35757,35005,752,11,,,
31568,18009,13559,11,,,
23392,11727,11665,11,,,
23636,19396,4240,9,,,
29695,5715,23980,7,,,
29533,29285,248,12,,,
29665,6430,23235,10,,,
31897,5062,26835,18,,,
29744,17331,12413,15,,,
27547,24394,3153,17,,,
29454,25122,4332,12,,,
30178,1559,28619,5,,,
31414,7939,23475,14,,,
30347,3443,26904,13,,,
35442,34311,1131,8,,,
21799,11689,10110,7,,,
25776,20265,5511,8,,,
23658,5289,18369,20,,,
23835,20638,3197,16,,,
37965,7211,30754,29,,,
30088,26937,3151,17,,,
21528,18459,3069,24,,,
31227,5843,25384,21,,,
28211,27340,871,5,,,
32115,30373,1742,17,,,
27843,25803,2040,14,,,
29368,16999,12369,12,,,
27571,13833,13738,9,,,
39861,22695,17166,11,,,
31771,12836,18935,9,,,
29935,9531,20404,23,,,
27725,13466,14259,10,,,
26023,5295,20728,11,,,
29458,10816,18642,20,,,
25643,11251,14392,12,,,
27811,27252,559,13,,,
25615,24666,949,19,,,
27743,6129,21614,21,,,
33335,21745,11590,10,,,
33866,8193,25673,13,,,
28184,7497,20687,14,,,
28908,89,28819,18,,,
27446,8158,19288,17,,,
31951,5159,26792,15,,,
30109,29416,693,21,,,
31886,1567,30319,18,,,
31613,8478,23135,10,,,
29530,5388,24142,13,,,
25307,14867,10440,17,,,
32742,4053,28689,5,,,
27441,19852,7589,13,,,
31564,13780,17784,7,,,
21973,2098,19875,20,,,
33406,31378,2028,5,,,
29789,23697,6092,8,,,
32079,3596,28483,15,,,
37295,9594,27701,11,,,
29948,24454,5494,8,,,
19880,10032,9848,10,,,
35258,28704,6554,11,,,
35447,13739,21708,9,,,
21949,12462,9487,20,,,
21565,6786,14779,7,,,
29610,12065,17545,9,,,
36371,7719,28652,10,,,
33703,16478,17225,18,,,
37992,672,37320,18,,,
29761,10515,19246,18,,,
35308,17751,17557,6,,,
27138,23101,4037,12,,,
32625,27414,5211,20,,,
37399,6438,30961,14,,,
32329,15123,17206,16,,,
31918,24972,6946,15,,,
27403,329,27074,18,,,
27206,13750,13456,13,,,
25151,18587,6564,11,,,
36013,30774,5239,11,,,
27386,25582,1804,20,,,
32947,5530,27417,8,,,
29119,11859,17260,8,,,
31083,14959,16124,11,,,
33142,17199,15943,13,,,
29918,27136,2782,14,,,
33721,31239,2482,8,,,
27575,10322,17253,18,,,
33107,21553,11554,14,,,
25838,15541,10297,9,,,
29946,28148,1798,11,,,
25337,12829,12508,5,,,
35033,28269,6764,5,,,
31436,15357,16079,16,,,
35544,27294,8250,9,,,
34164,19194,14970,11,,,
33464,5023,28441,13,,,
31741,14140,17601,18,,,
22051,18018,4033,19,,,
32019,14668,17351,5,,,
35770,974,34796,7,,,
27237,914,26323,19,,,
27988,5306,22682,13,,,
33895,19734,14161,13,,,
31291,4617,26674,7,,,
34100,10954,23146,4,,,
31432,22221,9211,7,,,
26855,16514,10341,13,,,
29606,14315,15291,10,,,
25580,19590,5990,12,,,
25272,16011,9261,22,,,
28014,8292,19722,10,,,
27876,12172,15704,21,,,
25560,3844,21716,11,,,
29203,28252,951,20,,,
30117,15663,14454,9,,,
20400,12975,7425,14,,,
25308,18512,6796,10,,,
31406,24206,7200,15,,,
31807,21727,10080,16,,,
27590,11817,15773,29,,,
33725,16279,17446,10,,,
28072,4747,23325,18,,,
37403,5065,32338,14,,,
25785,21126,4659,23,,,
31558,1899,29659,13,,,
27735,19894,7841,12,,,
32316,18368,13948,7,,,
32267,31776,491,5,,,
32676,3769,28907,9,,,
29810,11327,18483,7,,,
38822,8100,30722,13,,,
33190,12183,21007,3,,,
31817,23975,7842,17,,,
29220,1001,28219,18,,,
36999,7687,29312,17,,,
23892,11118,12774,16,,,
31505,18258,13247,25,,,
27653,16712,10941,17,,,
33730,6152,27578,12,,,
32988,5986,27002,10,,,
26950,4232,22718,16,,,
33511,13274,20237,13,,,
19854,15977,3877,15,,,
33534,1718,31816,15,,,
32376,30149,2227,14,,,
33042,7339,25703,17,,,
33259,10826,22433,17,,,
27977,13339,14638,6,,,
35568,34113,1455,18,,,
33376,13657,19719,11,,,
30060,10532,19528,16,,,
31029,26839,4190,9,,,
34519,21485,13034,13,,,
21510,15640,5870,21,,,
31865,14670,17195,9,,,
28212,15160,13052,10,,,
25434,21918,3516,25,,,
35863,2137,33726,8,,,
27918,7796,20122,4,,,
37655,35390,2265,16,,,
32371,10308,22063,10,,,
26153,11852,14301,12,,,
31426,27147,4279,18,,,
27313,14235,13078,10,,,
21376,2177,19199,10,,,
34029,13877,20152,10,,,
27461,12233,15228,5,,,
27792,21056,6736,12,,,
29484,13332,16152,8,,,
31303,26616,4687,10,,,
36009,4678,31331,17,,,
31718,19738,11980,19,,,
33661,6342,27319,17,,,
28330,9358,18972,10,,,
36240,29942,6298,13,,,
27820,21587,6233,11,,,
27713,15150,12563,21,,,
28597,6575,22022,8,,,
36773,2089,34684,13,,,
32249,11635,20614,11,,,
32332,2245,30087,14,,,
19392,16884,2508,16,,,
36660,14731,21929,8,,,
29509,10630,18879,13,,,
37701,24973,12728,17,,,
35915,3501,32414,14,,,
35744,34322,1422,20,,,
33550,7499,26051,21,,,
28964,19306,9658,21,,,
37757,1474,36283,10,,,
35157,3126,32031,6,,,
27569,20368,7201,15,,,
34657,27609,7048,20,,,
21797,15002,6795,20,,,
35936,12855,23081,8,,,
35842,2942,32900,16,,,
24985,24081,904,9,,,
29934,2944,26990,9,,,
31508,3318,28190,12,,,
29287,1100,28187,8,,,
20168,4268,15900,11,,,
35369,15250,20119,21,,,
27803,306,27497,21,,,
29407,28152,1255,17,,,
33437,26739,6698,8,,,
31951,14082,17869,13,,,
30258,19981,10277,24,,,
33710,18357,15353,7,,,
29597,16814,12783,19,,,
26969,26011,958,7,,,
25687,11962,13725,15,,,
31675,4442,27233,7,,,
33451,31056,2395,17,,,
29448,27703,1745,9,,,
21273,12064,9209,16,,,
33213,13764,19449,18,,,
35771,29804,5967,18,,,
33382,6893,26489,18,,,
23718,4811,18907,20,,,
33339,13925,19414,18,,,
31652,11862,19790,16,,,
33472,21245,12227,6,,,
27947,26155,1792,8,,,
32094,17151,14943,14,,,
27205,24773,2432,15,,,
25770,4492,21278,7,,,
29713,28607,1106,7,,,
29209,15018,14191,8,,,
28026,17489,10537,14,,,
27432,13005,14427,14,,,
31567,20648,10919,18,,,
33346,6588,26758,9,,,
29626,27300,2326,15,,,
36993,15072,21921,10,,,
27592,24295,3297,18,,,
27353,21745,5608,9,,,
30164,6403,23761,9,,,
25871,4896,20975,8,,,
33573,2325,31248,15,,,
32379,25266,7113,11,,,
29865,24530,5335,15,,,
27944,25803,2141,21,,,
31427,10841,20586,17,,,
32530,30631,1899,16,,,
35306,9780,25526,8,,,
30228,2062,28166,16,,,
28989,13498,15491,13,,,
29118,15292,13826,9,,,
35493,17107,18386,8,,,
33749,5019,28730,26,,,
23643,2754,20889,17,,,
27545,25782,1763,5,,,
29509,29233,276,10,,,
31323,3250,28073,12,,,
31645,16767,14878,19,,,
27921,17074,10847,22,,,
25938,24209,1729,11,,,
31770,21856,9914,17,,,
28880,2874,26006,9,,,
22177,14073,8104,15,,,
31744,18154,13590,16,,,
26673,24545,2128,16,,,
29574,658,28916,7,,,
29785,27846,1939,7,,,
29615,22659,6956,12,,,
28920,12022,16898,17,,,
29137,22412,6725,14,,,
29945,19247,10698,11,,,
27245,15745,11500,9,,,
29821,27324,2497,15,,,
33585,30390,3195,21,,,
29416,24686,4730,14,,,
27613,19186,8427,11,,,
23638,10650,12988,22,,,
31774,159,31615,12,,,
21541,9363,12178,10,,,
35955,5468,30487,9,,,
33274,31070,2204,11,,,
31014,4228,26786,10,,,
31953,19128,12825,15,,,
36166,1974,34192,11,,,
33745,19018,14727,16,,,
29867,17882,11985,10,,,
33516,27859,5657,22,,,
31595,12984,18611,10,,,
27235,14491,12744,17,,,
25456,3804,21652,8,,,
25498,1392,24106,14,,,
27854,21051,6803,18,,,
27574,10911,16663,8,,,
34958,22348,12610,6,,,
29826,21485,8341,6,,,
27377,16491,10886,8,,,
28068,12245,15823,8,,,
27473,20695,6778,5,,,
23829,3508,20321,8,,,
27611,20081,7530,20,,,
29714,29513,201,18,,,
23553,4509,19044,12,,,
34653,1246,33407,24,,,
27968,25117,2851,18,,,
25203,10243,14960,8,,,
27423,17529,9894,19,,,
31088,10390,20698,15,,,
28045,5334,22711,12,,,
26024,14369,11655,11,,,
23798,9451,14347,12,,,
25057,14002,11055,15,,,
38223,7959,30264,15,,,
31445,236,31209,16,,,
29722,2430,27292,17,,,
25398,21687,3711,9,,,
38751,3679,35072,12,,,
33927,3135,30792,28,,,
29266,14231,15035,10,,,
26061,18316,7745,15,,,
29823,23105,6718,5,,,
27780,22186,5594,8,,,
27640,27483,157,20,,,
31757,29492,2265,5,,,
29780,23559,6221,12,,,
22008,17937,4071,8,,,
31103,11017,20086,11,,,
33594,32594,1000,8,,,
31638,16328,15310,12,,,
33995,3289,30706,9,,,
35508,31770,3738,19,,,
33157,4857,28300,11,,,
19274,14785,4489,8,,,
28232,18044,10188,11,,,
34543,24649,9894,8,,,
33158,26578,6580,26,,,
26138,15367,10771,11,,,
33540,30924,2616,25,,,
27878,17833,10045,15,,,
26010,9460,16550,14,,,
24876,16187,8689,19,,,
31275,20092,11183,20,,,
36095,31619,4476,11,,,
23312,3807,19505,18,,,
29418,1375,28043,7,,,
26886,25905,981,15,,,
31780,24323,7457,20,,,
31666,1755,29911,18,,,
29773,6529,23244,22,,,
29488,27517,1971,13,,,
31703,6741,24962,10,,,
29302,26385,2917,14,,,
26048,11674,14374,8,,,
29185,15490,13695,6,,,
33849,753,33096,23,,,
30224,394,29830,13,,,
31080,22544,8536,4,,,
21935,3804,18131,17,,,
31384,3490,27894,19,,,
35870,22066,13804,14,,,
35619,19952,15667,16,,,
17898,11124,6774,13,,,
27642,10529,17113,17,,,
33300,18799,14501,13,,,
29234,157,29077,11,,,
25259,9114,16145,18,,,
24891,17161,7730,16,,,
29564,27339,2225,12,,,
29457,9447,20010,12,,,
31998,10724,21274,6,,,
29071,10312,18759,6,,,
29932,26056,3876,12,,,
26797,4936,21861,5,,,
38042,32396,5646,13,,,
30503,3892,26611,19,,,
26091,6875,19216,8,,,
26991,19290,7701,8,,,
29872,26551,3321,6,,,
33495,22648,10847,15,,,
30050,11786,18264,9,,,
27849,18496,9353,18,,,
27327,12583,14744,17,,,
24977,2689,22288,19,,,
29897,973,28924,19,,,
29949,13201,16748,12,,,
38366,36126,2240,9,,,
32934,2743,30191,8,,,
37409,15647,21762,5,,,
21562,13933,7629,9,,,
29367,27587,1780,7,,,
27804,26738,1066,10,,,
29996,24003,5993,10,,,
30056,15949,14107,10,,,
25704,2474,23230,14,,,
33697,13508,20189,28,,,
26331,26274,57,16,,,
26050,21488,4562,19,,,
31195,18539,12656,10,,,
33610,6976,26634,20,,,
27752,9531,18221,17,,,
35605,15732,19873,12,,,
19915,18349,1566,18,,,
33724,19071,14653,10,,,
35198,32550,2648,14,,,
25290,7407,17883,14,,,
27647,17564,10083,9,,,
31195,30773,422,26,,,
37897,6992,30905,13,,,
38354,15307,23047,18,,,
29486,22868,6618,6,,,
27231,3400,23831,18,,,
25523,7885,17638,18,,,
35609,32775,2834,9,,,
25879,9734,16145,13,,,
27848,3210,24638,5,,,
21819,15029,6790,15,,,
33669,7147,26522,17,,,
30991,11244,19747,9,,,
13408,10353,3055,17,,,
25304,4314,20990,9,,,
31459,15408,16051,16,,,
32136,11004,21132,21,,,
25252,13156,12096,20,,,
27800,26154,1646,11,,,
38127,21013,17114,8,,,
29865,14505,15360,8,,,
27437,10353,17084,18,,,
31252,3828,27424,7,,,
21827,12680,9147,8,,,
29358,27867,1491,16,,,
31160,1189,29971,9,,,
21915,9662,12253,7,,,
30806,3903,26903,12,,,
32952,31510,1442,21,,,
29818,23365,6453,17,,,
28001,2266,25735,12,,,
32085,2422,29663,10,,,
27984,18077,9907,6,,,
31595,29971,1624,11,,,
31539,7945,23594,10,,,
29083,4292,24791,15,,,
35903,3786,32117,10,,,
34704,33049,1655,14,,,
25533,9091,16442,19,,,
35629,6667,28962,17,,,
29667,22655,7012,20,,,
33400,9501,23899,10,,,
32386,29292,3094,6,,,
29296,9849,19447,9,,,
18878,11413,7465,10,,,
28158,25160,2998,14,,,
28379,5341,23038,25,,,
27422,19984,7438,10,,,
19492,128,19364,25,,,
33659,4997,28662,11,,,
33826,20007,13819,20,,,
19436,2366,17070,6,,,
30399,14616,15783,9,,,
24295,128,24167,16,,,
23788,23162,626,21,,,
35808,41,35767,9,,,
33625,10036,23589,23,,,
25655,25532,123,5,,,
34272,23829,10443,19,,,
23682,10817,12865,11,,,
35077,6213,28864,9,,,
35394,2604,32790,20,,,
32273,22806,9467,11,,,
31054,11340,19714,9,,,
27788,13510,14278,8,,,
34742,17389,17353,24,,,
29502,8144,21358,15,,,
32031,31518,513,13,,,
33824,25641,8183,12,,,
29921,9585,20336,13,,,
30933,13993,16940,16,,,
33763,5997,27766,8,,,
28982,18062,10920,5,,,
27453,51,27402,14,,,
37943,165,37778,18,,,
26924,3836,23088,15,,,
27880,10465,17415,14,,,
35672,13149,22523,8,,,
32052,15683,16369,9,,,
25336,14767,10569,9,,,
27840,27618,222,13,,,
27921,13252,14669,11,,,
27689,22881,4808,14,,,
27738,7679,20059,17,,,
34957,13811,21146,14,,,
25833,23496,2337,7,,,
31429,14678,16751,7,,,
29262,1601,27661,17,,,
32191,1976,30215,12,,,
35078,7017,28061,15,,,
26851,10620,16231,17,,,
30878,13544,17334,8,,,
31881,18423,13458,19,,,
31421,6667,24754,11,,,
32206,10433,21773,24,,,
25439,11495,13944,8,,,
34035,4561,29474,20,,,
32938,1214,31724,12,,,
33169,48,33121,11,,,
30893,6890,24003,10,,,
31233,20896,10337,5,,,
28229,22479,5750,7,,,
33581,27580,6001,20,,,
35384,24186,11198,9,,,
28149,11931,16218,23,,,
23354,5625,17729,5,,,
27334,19186,8148,14,,,
33679,24415,9264,11,,,
29313,23427,5886,13,,,
35267,11773,23494,32,,,
31059,28140,2919,10,,,
25961,9737,16224,6,,,
36028,2466,33562,16,,,
29484,21949,7535,13,,,
27430,8292,19138,10,,,
30348,5513,24835,33,,,
25095,20363,4732,9,,,
27590,309,27281,9,,,
31542,12486,19056,9,,,
27633,8181,19452,15,,,
24173,10542,13631,7,,,
29286,13134,16152,17,,,
29886,6177,23709,21,,,
31524,13393,18131,9,,,
27074,24042,3032,15,,,
29880,22255,7625,14,,,
25817,12339,13478,12,,,
33577,1370,32207,8,,,
33117,31135,1982,17,,,
31294,30632,662,19,,,
29163,2733,26430,7,,,
37861,13182,24679,17,,,
23895,8125,15770,15,,,
30175,24183,5992,6,,,
33817,14171,19646,19,,,
30359,27549,2810,16,,,
17723,9717,8006,13,,,
33254,13579,19675,12,,,
23691,3230,20461,16,,,
31375,12685,18690,13,,,
23421,4604,18817,5,,,
25553,5563,19990,14,,,
35832,18572,17260,13,,,
25690,25499,191,24,,,
35494,25119,10375,5,,,
33845,12434,21411,14,,,
29836,13327,16509,9,,,
24073,6992,17081,8,,,
27424,2005,25419,7,,,
33415,5091,28324,15,,,
18402,17185,1217,16,,,
23900,22199,1701,8,,,
31557,2319,29238,19,,,
26715,17798,8917,16,,,
31371,5035,26336,11,,,
29107,1375,27732,14,,,
29262,9418,19844,15,,,
23817,4706,19111,16,,,
34432,19552,14880,12,,,
15705,13122,2583,13,,,
25514,2313,23201,6,,,
33285,4490,28795,7,,,
37524,32201,5323,8,,,
24618,11167,13451,12,,,
35700,8329,27371,8,,,
33314,26147,7167,7,,,
25367,11136,14231,12,,,
21500,3705,17795,14,,,
29791,2166,27625,13,,,
27970,17560,10410,17,,,
29531,14301,15230,21,,,
32853,5186,27667,10,,,
29699,14114,15585,14,,,
25532,16252,9280,10,,,
29236,25631,3605,10,,,
27678,240,27438,4,,,
29850,10753,19097,19,,,
30090,29420,670,4,,,
27596,21507,6089,8,,,
33485,16304,17181,15,,,
21552,6446,15106,19,,,
34645,34403,242,11,,,
25460,23251,2209,10,,,
26070,1143,24927,9,,,
29743,23374,6369,18,,,
29607,12995,16612,14,,,
27119,15484,11635,6,,,
35518,21081,14437,10,,,
27572,23384,4188,11,,,
29277,25636,3641,12,,,
22626,17234,5392,13,,,
37692,2205,35487,13,,,
33443,25127,8316,19,,,
21680,978,20702,16,,,
30039,13709,16330,14,,,
28056,8441,19615,10,,,
25046,10158,14888,8,,,
27491,20084,7407,12,,,
28933,28572,361,12,,,
29161,21857,7304,13,,,
25674,5483,20191,10,,,
33342,2148,31194,6,,,
25178,15686,9492,12,,,
33347,18867,14480,9,,,
30135,13449,16686,10,,,
23839,20539,3300,8,,,
30348,26016,4332,18,,,
29520,16716,12804,8,,,
30124,12043,18081,17,,,
23593,6516,17077,16,,,
37401,1028,36373,9,,,
33940,28739,5201,13,,,
34573,22173,12400,13,,,
31935,9796,22139,7,,,
25428,13173,12255,8,,,
34079,33889,190,19,,,
21246,264,20982,14,,,
29238,10577,18661,9,,,
29543,4610,24933,16,,,
29974,23981,5993,8,,,
33359,922,32437,9,,,
35644,779,34865,16,,,
33226,18479,14747,23,,,
25543,19391,6152,24,,,
31003,10323,20680,17,,,
30080,11003,19077,14,,,
31302,18999,12303,11,,,
31773,7608,24165,15,,,
29715,12784,16931,16,,,
27650,18994,8656,13,,,
31827,14090,17737,18,,,
19641,1218,18423,9,,,
29749,29528,221,5,,,
31056,30743,313,9,,,
29586,24566,5020,12,,,
25428,21318,4110,17,,,
21960,3770,18190,8,,,
27194,7913,19281,16,,,
18962,15016,3946,13,,,
34863,18043,16820,9,,,
31619,28750,2869,13,,,
31163,27099,4064,19,,,
27913,11288,16625,18,,,
27592,25908,1684,15,,,
35170,31274,3896,15,,,
28091,18336,9755,13,,,
23532,3228,20304,14,,,
28234,11293,16941,18,,,
25708,15655,10053,19,,,
28244,12589,15655,10,,,
33427,22507,10920,15,,,
28057,6044,22013,16,,,
29791,9156,20635,15,,,
25352,7216,18136,17,,,
37818,16044,21774,9,,,
31199,25951,5248,19,,,
31069,13875,17194,6,,,
34387,27543,6844,12,,,
27816,22141,5675,17,,,
25320,15818,9502,4,,,
29497,3970,25527,11,,,
25795,6922,18873,13,,,
26102,7724,18378,14,,,
26456,21872,4584,14,,,
34114,3751,30363,14,,,
29563,2121,27442,20,,,
36435,7076,29359,14,,,
29636,11838,17798,20,,,
26364,208,26156,22,,,
29699,7544,22155,16,,,
33023,7232,25791,15,,,
19699,6908,12791,20,,,
25919,17491,8428,6,,,
33649,19550,14099,22,,,
28061,13843,14218,14,,,
31422,15379,16043,17,,,
35352,4991,30361,8,,,
28893,8186,20707,6,,,
28057,22673,5384,13,,,
23735,11055,12680,12,,,
29744,24294,5450,7,,,
33545,8373,25172,21,,,
29443,14474,14969,15,,,
31612,25835,5777,14,,,
32309,26410,5899,19,,,
28911,2157,26754,7,,,
33521,20063,13458,14,,,
27012,9066,17946,24,,,
25942,22692,3250,14,,,
25918,7690,18228,11,,,
31861,12951,18910,9,,,
29527,2222,27305,13,,,
28098,22553,5545,13,,,
35739,29604,6135,13,,,
33434,29095,4339,7,,,
39760,3183,36577,22,,,
27800,3076,24724,18,,,
28102,20975,7127,9,,,
19879,19795,84,13,,,
33275,16475,16800,14,,,
29454,5258,24196,10,,,
35930,34271,1659,11,,,
32781,19342,13439,14,,,
30153,24970,5183,13,,,
32264,10318,21946,16,,,
31354,3409,27945,14,,,
27425,11615,15810,20,,,
29608,19448,10160,21,,,
27260,20417,6843,27,,,
24194,17982,6212,10,,,
31135,29030,2105,10,,,
31735,12374,19361,11,,,
33888,2413,31475,15,,,
29142,18584,10558,19,,,
25503,20942,4561,12,,,
21874,4401,17473,18,,,
31884,7634,24250,21,,,
33700,11324,22376,15,,,
29220,7408,21812,13,,,
33277,26724,6553,10,,,
25600,20104,5496,16,,,
32815,30643,2172,14,,,
27273,11753,15520,12,,,
31185,23751,7434,10,,,
31730,25313,6417,15,,,
28878,13727,15151,22,,,
33090,30470,2620,15,,,
21508,2941,18567,6,,,
21655,5012,16643,10,,,
34297,30447,3850,8,,,
33675,1949,31726,7,,,
35190,16449,18741,9,,,
29497,20226,9271,12,,,
24809,23530,1279,15,,,
35597,29112,6485,8,,,
31850,2323,29527,11,,,
34119,9689,24430,15,,,
39411,34938,4473,13,,,
27390,23734,3656,18,,,
30080,29969,111,19,,,
33200,12229,20971,17,,,
29887,12772,17115,28,,,
30804,11431,19373,22,,,
21049,1247,19802,5,,,
37307,17269,20038,12,,,
24952,3914,21038,18,,,
29780,13781,15999,10,,,
25127,4407,20720,8,,,
30124,22402,7722,8,,,
26123,21522,4601,14,,,
27289,12889,14400,18,,,
25626,15834,9792,9,,,
34640,10800,23840,11,,,
28441,9457,18984,14,,,
29664,21602,8062,19,,,
29781,9867,19914,13,,,
27697,27130,567,15,,,
25847,24182,1665,18,,,
35276,27665,7611,14,,,
27557,5484,22073,22,,,
27683,19119,8564,9,,,
33885,13808,20077,15,,,
23851,16817,7034,11,,,
29227,13609,15618,15,,,
31029,20714,10315,8,,,
29067,27187,1880,10,,,
23772,198,23574,9,,,
30002,29140,862,22,,,
21744,19158,2586,18,,,
26511,8769,17742,18,,,
25374,7714,17660,10,,,
27584,16030,11554,11,,,
29854,8580,21274,8,,,
31601,16244,15357,20,,,
33528,15308,18220,9,,,
31675,20639,11036,14,,,
34639,10542,24097,7,,,
27334,18278,9056,8,,,
29598,14454,15144,21,,,
21660,203,21457,14,,,
27160,18648,8512,9,,,
31877,29435,2442,5,,,
33896,6185,27711,20,,,
23235,14651,8584,16,,,
29233,13450,15783,11,,,
33694,12146,21548,3,,,
21734,11478,10256,10,,,
31710,26209,5501,12,,,
36079,27482,8597,17,,,
21307,334,20973,20,,,
33254,30757,2497,14,,,
27103,11660,15443,17,,,
29907,28888,1019,15,,,
25138,9338,15800,14,,,
36441,11305,25136,13,,,
34449,9328,25121,17,,,
27805,10706,17099,9,,,
32196,25145,7051,11,,,
32186,17599,14587,4,,,
36028,24825,11203,9,,,
21725,6053,15672,14,,,
22007,13150,8857,8,,,
27755,24133,3622,14,,,
35788,23210,12578,9,,,
31236,19186,12050,10,,,
30277,3759,26518,20,,,
29412,18035,11377,9,,,
29403,28038,1365,7,,,
28818,8061,20757,14,,,
29518,28371,1147,21,,,
33961,20214,13747,6,,,
31313,17917,13396,22,,,
31477,29948,1529,23,,,
35025,17224,17801,13,,,
25522,645,24877,11,,,
33889,27989,5900,6,,,
19818,14757,5061,9,,,
31391,24245,7146,16,,,
31714,18720,12994,21,,,
35124,15380,19744,19,,,
31800,26422,5378,15,,,
33426,29879,3547,15,,,
29214,1687,27527,13,,,
21753,13107,8646,6,,,
35577,33256,2321,21,,,
27774,22867,4907,5,,,
25687,8270,17417,21,,,
31672,26656,5016,15,,,
24614,1324,23290,14,,,
23978,14615,9363,11,,,
25690,17193,8497,22,,,
31781,12023,19758,10,,,
31509,10022,21487,17,,,
35038,23696,11342,12,,,
31542,6926,24616,28,,,
31873,30127,1746,22,,,
33579,32834,745,13,,,
17949,8106,9843,5,,,
25575,3566,22009,12,,,
31914,2965,28949,8,,,
31808,18651,13157,16,,,
26371,695,25676,28,,,
26360,21177,5183,18,,,
38339,15534,22805,18,,,
21484,5616,15868,13,,,
38958,11984,26974,18,,,
30112,2779,27333,15,,,
34000,25232,8768,11,,,
29338,5615,23723,12,,,
34867,26092,8775,6,,,
29860,521,29339,19,,,
29598,18158,11440,4,,,
32806,28642,4164,17,,,
27510,1797,25713,17,,,
32146,9754,22392,7,,,
30360,22861,7499,7,,,
35156,10082,25074,20,,,
29623,27763,1860,6,,,
32400,4262,28138,3,,,
35958,18941,17017,22,,,
33939,32427,1512,8,,,
34384,13611,20773,8,,,
29361,25981,3380,23,,,
28795,19088,9707,18,,,
27675,4961,22714,9,,,
37893,24934,12959,20,,,
38255,5312,32943,11,,,
27416,24366,3050,10,,,
17987,16377,1610,8,,,
27810,16825,10985,15,,,
25975,17793,8182,13,,,
31620,11109,20511,21,,,
33749,27123,6626,10,,,
25086,4490,20596,16,,,
31341,24589,6752,10,,,
31702,14463,17239,16,,,
26142,9586,16556,8,,,
23590,5093,18497,26,,,
23743,17188,6555,14,,,
37404,14942,22462,16,,,
26211,3704,22507,16,,,
19296,6519,12777,25,,,
27916,9389,18527,14,,,
35572,20735,14837,13,,,
23243,10871,12372,8,,,
33761,9551,24210,11,,,
21873,16003,5870,26,,,
29962,6358,23604,6,,,
25962,7265,18697,24,,,
37758,15482,22276,19,,,
27971,27875,96,8,,,
35448,3478,31970,16,,,
27846,5695,22151,7,,,
27884,24818,3066,13,,,
37595,3419,34176,11,,,
27681,25411,2270,9,,,
27476,23121,4355,5,,,
31418,21329,10089,14,,,
27724,3924,23800,37,,,
33741,19592,14149,9,,,
28209,5516,22693,9,,,
20101,8785,11316,20,,,
25021,22702,2319,22,,,
25952,12888,13064,14,,,
29801,2617,27184,15,,,
25920,20221,5699,10,,,
34265,12979,21286,18,,,
31081,10234,20847,9,,,
35101,9664,25437,15,,,
26965,9841,17124,18,,,
27753,21061,6692,16,,,
30901,22164,8737,11,,,
23665,9939,13726,10,,,
21996,6293,15703,18,,,
29753,21677,8076,14,,,
31423,4434,26989,14,,,
25551,5730,19821,15,,,
31196,30067,1129,23,,,
19600,4852,14748,18,,,
29843,16311,13532,19,,,
26931,24174,2757,8,,,
19597,9329,10268,17,,,
28364,9001,19363,16,,,
27474,4759,22715,14,,,
29115,17639,11476,15,,,
21331,7019,14312,8,,,
36077,1671,34406,13,,,
34030,864,33166,25,,,
29824,29416,408,8,,,
31571,11750,19821,14,,,
35828,4459,31369,15,,,
26423,4133,22290,13,,,
21206,7594,13612,19,,,
32015,13908,18107,15,,,
25555,18067,7488,22,,,
25718,13515,12203,21,,,
31515,19001,12514,7,,,
27737,1161,26576,14,,,
30198,58,30140,21,,,
31334,24111,7223,4,,,
31591,15633,15958,6,,,
25618,297,25321,18,,,
27324,22022,5302,13,,,
33597,14438,19159,10,,,
29360,11382,17978,9,,,
23367,12644,10723,12,,,
33242,30559,2683,10,,,
25431,21473,3958,21,,,
33140,23733,9407,16,,,
33215,23509,9706,10,,,
31745,24242,7503,13,,,
27831,16372,11459,16,,,
29560,28602,958,18,,,
29836,11945,17891,8,,,
28980,17157,11823,7,,,
27133,17838,9295,29,,,
29037,19135,9902,28,,,
29403,6962,22441,8,,,
26303,13037,13266,12,,,
26798,13801,12997,9,,,
33582,32570,1012,5,,,
37781,21571,16210,16,,,
35909,32644,3265,13,,,
36429,10694,25735,5,,,
21680,13878,7802,15,,,
37765,14068,23697,8,,,
31591,1195,30396,18,,,
31248,28843,2405,11,,,
28945,7452,21493,39,,,
23476,11098,12378,13,,,
21077,4290,16787,12,,,
27754,26408,1346,17,,,
27099,22908,4191,12,,,
33463,3308,30155,25,,,
25913,17663,8250,17,,,
29523,7655,21868,15,,,
36722,7436,29286,10,,,
35363,21392,13971,15,,,
33251,2605,30646,11,,,
28380,21736,6644,12,,,
32717,6539,26178,16,,,
23707,15861,7846,13,,,
22042,8106,13936,5,,,
29176,15240,13936,9,,,
33455,9590,23865,9,,,
30982,23146,7836,8,,,
30002,1233,28769,9,,,
29278,12959,16319,23,,,
25655,24181,1474,7,,,
23501,16953,6548,12,,,
33562,26017,7545,14,,,
31115,9375,21740,4,,,
29876,4976,24900,8,,,
29812,21062,8750,16,,,
30205,550,29655,13,,,
23553,9240,14313,14,,,
35354,5656,29698,12,,,
29401,17443,11958,9,,,
37531,16935,20596,13,,,
26061,19322,6739,25,,,
28177,20042,8135,20,,,
29814,23469,6345,13,,,
26299,1690,24609,12,,,
31813,19555,12258,13,,,
27659,27235,424,4,,,
27981,12530,15451,18,,,
33808,18798,15010,19,,,
25419,8504,16915,7,,,
23704,11678,12026,13,,,
29917,28171,1746,17,,,
27364,26586,778,9,,,
31475,4616,26859,3,,,
31343,8664,22679,18,,,
25946,7689,18257,6,,,
20040,10540,9500,8,,,
29613,25300,4313,10,,,
31820,15997,15823,22,,,
32222,6353,25869,6,,,
31375,25560,5815,12,,,
23023,6897,16126,17,,,
29568,18901,10667,10,,,
27290,3996,23294,21,,,
29571,11987,17584,16,,,
30092,19983,10109,12,,,
26590,8230,18360,20,,,
29547,8895,20652,15,,,
33170,31673,1497,14,,,
35733,8425,27308,10,,,
34660,9310,25350,19,,,
31589,2518,29071,18,,,
27785,24330,3455,6,,,
26166,10100,16066,15,,,
33546,33343,203,21,,,
33829,7195,26634,13,,,
27826,19875,7951,16,,,
25431,8509,16922,12,,,
33465,22262,11203,13,,,
30099,18214,11885,7,,,
30180,14996,15184,10,,,
31074,10411,20663,20,,,
27401,5362,22039,11,,,
25104,11709,13395,8,,,
33879,1411,32468,16,,,
33827,26108,7719,14,,,
30136,26940,3196,11,,,
35695,35212,483,17,,,
29488,13225,16263,10,,,
27252,23195,4057,13,,,
27561,7868,19693,7,,,
39521,9546,29975,15,,,
31884,9117,22767,10,,,
27574,18047,9527,21,,,
29653,745,28908,11,,,
30041,22481,7560,19,,,
23419,1020,22399,15,,,
29389,27813,1576,18,,,
31966,3353,28613,17,,,
23570,6548,17022,21,,,
28950,11828,17122,9,,,
31278,6098,25180,9,,,
26171,13159,13012,22,,,
17725,11550,6175,23,,,
27567,15827,11740,5,,,
24853,18500,6353,12,,,
27673,5379,22294,11,,,
27173,25867,1306,18,,,
31549,9881,21668,17,,,
27578,1958,25620,15,,,
32678,13089,19589,14,,,
27459,24267,3192,17,,,
29787,20023,9764,17,,,
26210,23678,2532,12,,,
18988,901,18087,19,,,
35663,24411,11252,5,,,
34950,34258,692,12,,,
24186,23226,960,12,,,
25959,13301,12658,10,,,
33468,20387,13081,10,,,
26606,7160,19446,9,,,
29627,25476,4151,38,,,
26066,24491,1575,13,,,
29507,18857,10650,20,,,
31695,16262,15433,10,,,
33285,23284,10001,6,,,
33618,17854,15764,14,,,
35049,28293,6756,5,,,
30661,26827,3834,12,,,
29921,19472,10449,12,,,
19671,7172,12499,13,,,
33687,807,32880,15,,,
28470,19845,8625,18,,,
30422,22645,7777,15,,,
27533,14106,13427,3,,,
25669,4579,21090,27,,,
27655,17744,9911,13,,,
29490,1180,28310,26,,,
35675,8641,27034,9,,,
27006,3665,23341,13,,,
24400,13358,11042,8,,,
24900,20993,3907,6,,,
27175,22007,5168,9,,,
27174,5082,22092,10,,,
30221,27544,2677,12,,,
27595,9719,17876,10,,,
32039,13986,18053,21,,,
31606,19436,12170,8,,,
37589,35806,1783,11,,,
23808,4074,19734,13,,,
27359,15660,11699,9,,,
30369,6204,24165,16,,,
19359,15200,4159,17,,,
24951,21220,3731,13,,,
31553,283,31270,8,,,
32000,1907,30093,15,,,
25503,19393,6110,9,,,
31356,19426,11930,7,,,
29467,26898,2569,14,,,
33610,13129,20481,11,,,
29280,3393,25887,12,,,
27021,15811,11210,15,,,
35724,3717,32007,9,,,
29836,16836,13000,25,,,
26112,14364,11748,8,,,
29774,7067,22707,5,,,
37428,18686,18742,9,,,
30936,21799,9137,7,,,
30943,5245,25698,12,,,
34180,21393,12787,9,,,
37978,976,37002,9,,,
37371,30479,6892,18,,,
35343,27042,8301,11,,,
28917,21144,7773,15,,,
27520,26443,1077,12,,,
29737,29259,478,17,,,
33552,5409,28143,18,,,
19372,6488,12884,13,,,
27825,20155,7670,15,,,
31708,4885,26823,13,,,
35654,17540,18114,6,,,
29956,4639,25317,10,,,
27332,20991,6341,10,,,
30215,26517,3698,8,,,
38341,20572,17769,12,,,
36439,9413,27026,21,,,
29904,26949,2955,14,,,
23885,20738,3147,25,,,
31854,27216,4638,18,,,
23290,23159,131,13,,,
31853,3401,28452,18,,,
33736,18575,15161,12,,,
25518,3084,22434,16,,,
25967,6692,19275,9,,,
31523,9286,22237,13,,,
32646,2660,29986,12,,,
21601,11401,10200,20,,,
35870,11683,24187,11,,,
27642,3746,23896,15,,,
21292,8022,13270,14,,,
23603,6164,17439,14,,,
31458,8187,23271,26,,,
29599,4207,25392,14,,,
34015,15271,18744,18,,,
27323,14162,13161,19,,,
27984,11859,16125,17,,,
32192,29036,3156,6,,,
21841,16059,5782,22,,,
21757,16238,5519,17,,,
33270,29898,3372,9,,,
27664,27035,629,12,,,
31569,8577,22992,15,,,
27443,25214,2229,5,,,
29796,26724,3072,16,,,
32642,20809,11833,17,,,
35892,24890,11002,5,,,
31765,16697,15068,21,,,
31425,4523,26902,12,,,
35901,4450,31451,17,,,
30208,24300,5908,18,,,
31496,27723,3773,13,,,
20103,5270,14833,7,,,
25948,17878,8070,19,,,
29215,5251,23964,10,,,
27209,11506,15703,9,,,
23474,11999,11475,11,,,
29648,11804,17844,17,,,
27222,21094,6128,9,,,
25553,3164,22389,14,,,
33294,31494,1800,16,,,
20323,13085,7238,11,,,
34445,18331,16114,20,,,
27211,5237,21974,5,,,
31991,14830,17161,8,,,
31719,19827,11892,18,,,
33887,24059,9828,15,,,
32029,16988,15041,9,,,
29721,25696,4025,12,,,
40088,11641,28447,10,,,
31901,20405,11496,13,,,
23299,12630,10669,14,,,
32847,17252,15595,12,,,
27170,8459,18711,17,,,
31241,20966,10275,13,,,
33862,2851,31011,27,,,
25130,18236,6894,17,,,
33148,6988,26160,4,,,
33897,24332,9565,14,,,
31102,15005,16097,5,,,
27840,19968,7872,15,,,
28077,20206,7871,18,,,
31389,21955,9434,9,,,
31650,17981,13669,12,,,
29770,832,28938,12,,,
31568,7406,24162,4,,,
27579,25189,2390,11,,,
35395,30687,4708,8,,,
35999,19469,16530,11,,,
29029,5010,24019,25,,,
23138,21745,1393,5,,,
33217,14880,18337,15,,,
33252,20194,13058,11,,,
23372,4976,18396,15,,,
25537,20173,5364,12,,,
29318,21628,7690,16,,,
29952,2029,27923,8,,,
31247,12531,18716,11,,,
29736,16281,13455,13,,,
23166,339,22827,13,,,
31629,9023,22606,13,,,
32826,151,32675,7,,,
27379,14187,13192,18,,,
29614,5830,23784,13,,,
27441,2905,24536,16,,,
26020,3055,22965,17,,,
29766,5841,23925,11,,,
40261,15280,24981,12,,,
25726,15624,10102,13,,,
33522,13676,19846,8,,,
27415,952,26463,12,,,
20049,8881,11168,22,,,
33985,26475,7510,19,,,
29570,18982,10588,20,,,
29831,21627,8204,4,,,
33175,891,32284,13,,,
29533,21347,8186,16,,,
28813,192,28621,11,,,
24889,5439,19450,17,,,
24713,22696,2017,6,,,
19675,16971,2704,15,,,
27321,24801,2520,10,,,
33488,16483,17005,13,,,
31223,4219,27004,11,,,
25764,22957,2807,8,,,
35294,11206,24088,16,,,
31938,30577,1361,27,,,
24918,13928,10990,18,,,
29421,19929,9492,23,,,
33980,7850,26130,8,,,
27601,25532,2069,8,,,
33950,18307,15643,12,,,
31691,3467,28224,22,,,
31627,8380,23247,10,,,
29622,20898,8724,11,,,
39989,5647,34342,8,,,
24201,23129,1072,18,,,
34056,33389,667,9,,,
31114,17049,14065,13,,,
35979,593,35386,18,,,
29789,20709,9080,16,,,
32318,7568,24750,18,,,
31562,21380,10182,18,,,
27578,13113,14465,15,,,
33138,18576,14562,9,,,
28306,23782,4524,13,,,
27581,7159,20422,14,,,
29349,5983,23366,17,,,
30106,3716,26390,11,,,
33262,14992,18270,12,,,
27619,22406,5213,10,,,
31708,25890,5818,14,,,
27980,9939,18041,8,,,
27434,20674,6760,8,,,
27755,23539,4216,21,,,
25543,13657,11886,16,,,
33420,32040,1380,7,,,
29781,7935,21846,17,,,
27329,11262,16067,14,,,
31001,14750,16251,16,,,
37885,35542,2343,9,,,
28438,5130,23308,22,,,
30239,1983,28256,21,,,
33988,27201,6787,6,,,
33544,4945,28599,17,,,
27615,23584,4031,5,,,
27667,16219,11448,11,,,
23732,16590,7142,29,,,
36353,7904,28449,19,,,
31744,21465,10279,14,,,
33104,17433,15671,16,,,
23326,21420,1906,20,,,
20126,9358,10768,22,,,
32059,20896,11163,17,,,
36504,6156,30348,10,,,
30591,14917,15674,13,,,
33901,27455,6446,16,,,
27340,15541,11799,6,,,
31588,5199,26389,7,,,
31768,9686,22082,8,,,
23541,15858,7683,9,,,
31910,31030,880,15,,,
35127,33534,1593,13,,,
29647,8901,20746,24,,,
27595,15983,11612,12,,,
30186,7656,22530,24,,,
23426,10614,12812,20,,,
27528,20444,7084,19,,,
29543,13183,16360,11,,,
33262,7141,26121,17,,,
33687,31062,2625,11,,,
28080,26176,1904,20,,,
25456,536,24920,12,,,
33470,15526,17944,8,,,
35617,19478,16139,14,,,
27465,4225,23240,13,,,
31625,3653,27972,9,,,
25636,12693,12943,14,,,
22925,15213,7712,15,,,
28141,16612,11529,14,,,
31854,21408,10446,15,,,
29494,1890,27604,10,,,
25358,6278,19080,18,,,
29775,25093,4682,5,,,
35029,15933,19096,22,,,
23433,20639,2794,9,,,
35945,22868,13077,10,,,
27294,23855,3439,23,,,
29991,1361,28630,14,,,
31447,28660,2787,10,,,
31349,10509,20840,11,,,
29193,13144,16049,12,,,
29266,11116,18150,13,,,
33088,18664,14424,9,,,
23720,22057,1663,4,,,
34067,5643,28424,20,,,
22202,4887,17315,7,,,
31838,3263,28575,10,,,
31646,20276,11370,12,,,
30043,29699,344,9,,,
31864,12910,18954,10,,,
27861,23940,3921,20,,,
31488,23185,8303,20,,,
25738,23889,1849,11,,,
29842,18959,10883,14,,,
23653,16811,6842,14,,,
25624,19988,5636,13,,,
23917,10681,13236,15,,,
32165,4867,27298,18,,,
31504,28691,2813,17,,,
25566,20741,4825,9,,,
29647,4327,25320,14,,,
31535,8889,22646,11,,,
37211,14815,22396,9,,,
25926,5578,20348,15,,,
29392,22104,7288,9,,,
28992,15178,13814,17,,,
35628,2430,33198,16,,,
31695,6421,25274,11,,,
33733,10837,22896,18,,,
35557,17480,18077,11,,,
29270,15317,13953,12,,,
19812,6968,12844,13,,,
27082,18734,8348,20,,,
25192,4503,20689,11,,,
33120,5374,27746,26,,,
31659,3194,28465,17,,,
29959,23455,6504,21,,,
32013,17288,14725,21,,,
29667,9802,19865,9,,,
32937,2623,30314,10,,,
32119,579,31540,14,,,
19593,15765,3828,9,,,
31380,26810,4570,16,,,
22084,2379,19705,19,,,
29177,13506,15671,13,,,
35768,11116,24652,18,,,
27232,13742,13490,11,,,
25466,13991,11475,28,,,
27054,12717,14337,14,,,
25406,15863,9543,18,,,
39725,18607,21118,19,,,
29721,21939,7782,15,,,
29345,19377,9968,12,,,
33814,20294,13520,13,,,
25545,19496,6049,18,,,
25136,2387,22749,18,,,
15375,2903,12472,18,,,
35629,8553,27076,25,,,
23902,9510,14392,5,,,
35570,20471,15099,9,,,
25659,9437,16222,26,,,
31792,7903,23889,15,,,
25664,4036,21628,6,,,
24905,9636,15269,7,,,
32058,27334,4724,18,,,
25753,3174,22579,11,,,
23178,14283,8895,11,,,
25546,10381,15165,15,,,
27674,12098,15576,14,,,
33211,5220,27991,5,,,
35921,10329,25592,18,,,
33091,13212,19879,14,,,
27874,4630,23244,15,,,
39673,32099,7574,10,,,
31368,6832,24536,26,,,
29217,5237,23980,15,,,
29938,14068,15870,23,,,
33383,32898,485,10,,,
32466,26617,5849,19,,,
27527,25877,1650,11,,,
27470,9667,17803,4,,,
35819,29348,6471,10,,,
27518,6118,21400,8,,,
29675,19834,9841,5,,,
31989,6109,25880,13,,,
27659,5449,22210,10,,,
29661,18642,11019,10,,,
32103,31377,726,15,,,
29493,8831,20662,20,,,
29527,20824,8703,10,,,
25195,289,24906,28,,,
33967,20902,13065,16,,,
33543,6659,26884,12,,,
30095,3899,26196,14,,,
27012,23519,3493,17,,,
35003,10934,24069,18,,,
27555,12662,14893,13,,,
29221,11450,17771,7,,,
32236,6308,25928,14,,,
25287,5685,19602,13,,,
27993,9329,18664,15,,,
27597,6325,21272,15,,,
27869,5084,22785,18,,,
27001,16688,10313,13,,,
35884,33003,2881,11,,,
33089,4297,28792,3,,,
25404,21119,4285,14,,,
23363,11870,11493,13,,,
32062,21643,10419,14,,,
31582,26990,4592,17,,,
25152,24148,1004,15,,,
21502,5632,15870,14,,,
27659,4571,23088,20,,,
29443,27350,2093,18,,,
31385,20838,10547,15,,,
31843,13580,18263,7,,,
24070,19445,4625,5,,,
27081,22529,4552,19,,,
29606,27920,1686,12,,,
27538,9242,18296,19,,,
27938,1858,26080,17,,,
36064,15139,20925,21,,,
23454,9494,13960,9,,,
31636,7600,24036,10,,,
27184,24245,2939,8,,,
30308,18059,12249,14,,,
28175,471,27704,4,,,
29598,19784,9814,4,,,
34217,22140,12077,10,,,
32566,8098,24468,13,,,
25924,22297,3627,14,,,
34200,15976,18224,8,,,
28216,7047,21169,13,,,
22850,5849,17001,11,,,
26498,22769,3729,17,,,
31795,9950,21845,25,,,
27428,21193,6235,7,,,
29178,15165,14013,27,,,
27083,22097,4986,9,,,
30644,26640,4004,13,,,
31532,13620,17912,19,,,
36634,4447,32187,15,,,
29022,8231,20791,12,,,
27781,4492,23289,19,,,
27608,20592,7016,15,,,
27453,14616,12837,7,,,
33745,3759,29986,11,,,
39825,6108,33717,13,,,
21720,4464,17256,18,,,
23681,7993,15688,18,,,
25399,10557,14842,33,,,
29526,9538,19988,17,,,
29504,29344,160,12,,,
33660,12780,20880,11,,,
35632,32104,3528,13,,,
23565,25,23540,13,,,
26347,3853,22494,9,,,
27207,8856,18351,10,,,
35397,3406,31991,13,,,
25986,20613,5373,6,,,
31920,1173,30747,16,,,
29128,9656,19472,12,,,
31749,27508,4241,6,,,
32247,28115,4132,13,,,
31938,28841,3097,24,,,
34154,2164,31990,14,,,
30928,6738,24190,7,,,
26902,21823,5079,13,,,
29846,21718,8128,12,,,
30223,18803,11420,15,,,
26380,2732,23648,11,,,
31426,1057,30369,8,,,
23859,8299,15560,11,,,
29417,27855,1562,17,,,
31935,8788,23147,14,,,
33808,31511,2297,14,,,
31617,4947,26670,16,,,
35122,29677,5445,9,,,
29543,15765,13778,22,,,
29265,4338,24927,5,,,
29867,5652,24215,8,,,
32662,26107,6555,17,,,
27544,3679,23865,15,,,
29608,24816,4792,17,,,
30237,17049,13188,16,,,
34030,33220,810,11,,,
27708,11702,16006,9,,,
34710,33749,961,31,,,
27923,11135,16788,21,,,
25821,4209,21612,17,,,
33073,2321,30752,19,,,
27717,11220,16497,24,,,
27876,18984,8892,5,,,
25960,13955,12005,26,,,
22121,6521,15600,12,,,
33567,26137,7430,11,,,
24735,10990,13745,8,,,
29745,16836,12909,14,,,
27991,241,27750,11,,,
29516,15279,14237,8,,,
33490,14235,19255,12,,,
27955,10966,16989,13,,,
27543,22131,5412,10,,,
22012,6647,15365,15,,,
31220,11194,20026,5,,,
33763,8694,25069,11,,,
23952,21503,2449,19,,,
31492,542,30950,11,,,
33161,4352,28809,15,,,
25536,11586,13950,13,,,
29492,25879,3613,18,,,
35480,20532,14948,13,,,
33738,80,33658,14,,,
25909,2243,23666,23,,,
28104,26234,1870,18,,,
34088,19111,14977,8,,,
29479,18880,10599,23,,,
31297,6792,24505,13,,,
33281,22502,10779,14,,,
30093,16485,13608,16,,,
25398,673,24725,14,,,
27598,12251,15347,18,,,
23405,8964,14441,18,,,
32000,24163,7837,15,,,
25465,2973,22492,4,,,
27166,17402,9764,20,,,
29654,27262,2392,15,,,
31504,5556,25948,16,,,
30392,12043,18349,8,,,
29550,14122,15428,11,,,
31049,40,31009,15,,,
26889,4395,22494,19,,,
33813,21289,12524,7,,,
29707,11536,18171,16,,,
33616,8408,25208,13,,,
24934,17103,7831,9,,,
31952,27389,4563,18,,,
33210,4840,28370,11,,,
27453,12697,14756,17,,,
29541,7878,21663,21,,,
33191,25150,8041,9,,,
30820,21711,9109,8,,,
24529,20465,4064,16,,,
32761,16996,15765,5,,,
25057,51,25006,13,,,
29539,17956,11583,13,,,
29442,24177,5265,18,,,
27682,5545,22137,8,,,
29405,27514,1891,16,,,
26868,13348,13520,6,,,
33444,25853,7591,25,,,
34661,7058,27603,13,,,
26134,5925,20209,18,,,
25596,6652,18944,15,,,
30104,14021,16083,14,,,
25295,8747,16548,16,,,
29355,12683,16672,19,,,
31478,20116,11362,17,,,
34535,15284,19251,14,,,
35929,15923,20006,5,,,
33960,22267,11693,25,,,
29600,11974,17626,14,,,
33274,5205,28069,6,,,
29851,24507,5344,14,,,
29237,2369,26868,23,,,
24112,21961,2151,14,,,
37087,1010,36077,9,,,
22754,6949,15805,20,,,
35613,20362,15251,9,,,
34510,18975,15535,12,,,
25885,17089,8796,13,,,
25229,21283,3946,13,,,
32893,3705,29188,10,,,
33601,25538,8063,19,,,
25461,5634,19827,15,,,
29715,7723,21992,10,,,
29108,27574,1534,12,,,
26528,15926,10602,15,,,
21318,12269,9049,15,,,
34240,16086,18154,14,,,
25776,2397,23379,10,,,
27761,14767,12994,11,,,
26938,15527,11411,19,,,
21810,7510,14300,15,,,
31261,22661,8600,10,,,
32220,10483,21737,12,,,
27707,10236,17471,21,,,
35907,21667,14240,18,,,
25638,594,25044,19,,,
29655,15707,13948,17,,,
31831,23503,8328,16,,,
36877,4164,32713,10,,,
29249,1146,28103,6,,,
31930,1877,30053,9,,,
29549,14349,15200,13,,,
23347,16264,7083,11,,,
27637,16735,10902,16,,,
29258,6345,22913,10,,,
27662,15074,12588,12,,,
29889,2893,26996,8,,,
29852,4622,25230,13,,,
27636,25543,2093,14,,,
34089,17967,16122,26,,,
25655,10077,15578,11,,,
33241,32090,1151,9,,,
31382,27617,3765,13,,,
25788,12746,13042,6,,,
29343,17195,12148,12,,,
28217,28090,127,5,,,
26226,2120,24106,12,,,
27412,17487,9925,8,,,
31328,26513,4815,14,,,
31364,28416,2948,11,,,
35877,35295,582,21,,,
28995,15155,13840,22,,,
33247,5766,27481,16,,,
29812,25282,4530,16,,,
18139,6362,11777,11,,,
33628,2115,31513,9,,,
39799,27844,11955,8,,,
23918,4754,19164,6,,,
30354,9954,20400,12,,,
25466,17173,8293,5,,,
33281,30485,2796,13,,,
31144,9783,21361,9,,,
27603,9024,18579,15,,,
27380,15157,12223,16,,,
33255,5346,27909,15,,,
29617,8709,20908,9,,,
29079,16738,12341,10,,,
31798,21903,9895,19,,,
30865,5863,25002,9,,,
25628,22611,3017,16,,,
25654,9358,16296,9,,,
31472,27658,3814,18,,,
31667,15374,16293,7,,,
32975,24905,8070,15,,,
37279,3734,33545,15,,,
25339,9034,16305,16,,,
33757,3421,30336,13,,,
31711,660,31051,17,,,
31712,25129,6583,4,,,
28183,23604,4579,9,,,
28126,25720,2406,11,,,
26793,8207,18586,16,,,
33462,28621,4841,18,,,
34021,2564,31457,5,,,
25758,20925,4833,24,,,
33594,31051,2543,21,,,
29327,18178,11149,18,,,
29258,15360,13898,8,,,
28825,16572,12253,7,,,
33437,10136,23301,8,,,
32045,28335,3710,8,,,
35378,32485,2893,11,,,
32151,8502,23649,23,,,
27354,1827,25527,16,,,
32507,24853,7654,11,,,
26311,18618,7693,13,,,
39459,39363,96,9,,,
31705,7989,23716,8,,,
29638,10057,19581,13,,,
19216,7298,11918,5,,,
33245,7606,25639,14,,,
31417,20388,11029,20,,,
31291,20179,11112,27,,,
23508,3594,19914,10,,,
28778,4615,24163,11,,,
22827,22533,294,14,,,
36321,1301,35020,14,,,
29616,26009,3607,13,,,
33287,8153,25134,14,,,
31937,5584,26353,13,,,
24012,3095,20917,15,,,
27472,25173,2299,17,,,
25667,13813,11854,4,,,
29078,20420,8658,12,,,
22993,8357,14636,8,,,
30395,23017,7378,15,,,
35947,29715,6232,5,,,
31188,17036,14152,6,,,
30168,1090,29078,10,,,
17776,2878,14898,13,,,
29257,24360,4897,18,,,
27804,2201,25603,14,,,
29484,19983,9501,22,,,
33431,26031,7400,26,,,
35776,13123,22653,13,,,
30471,24866,5605,9,,,
31561,16186,15375,14,,,
23696,15484,8212,11,,,
29674,2130,27544,17,,,
30176,28545,1631,19,,,
28250,13358,14892,14,,,
25742,23624,2118,17,,,
27447,13217,14230,7,,,
37676,14298,23378,21,,,
29798,14220,15578,10,,,
34243,8706,25537,7,,,
33230,414,32816,16,,,
29634,28336,1298,15,,,
33930,16878,17052,17,,,
29525,25990,3535,18,,,
26717,6188,20529,16,,,
26296,25152,1144,12,,,
25005,9921,15084,14,,,
32824,23933,8891,17,,,
32386,20817,11569,11,,,
33121,26013,7108,16,,,
31871,3696,28175,15,,,
29631,9655,19976,10,,,
35163,1874,33289,10,,,
27662,9671,17991,12,,,
19607,2656,16951,11,,,
25582,290,25292,11,,,
31267,14,31253,17,,,
27544,20685,6859,21,,,
21785,9363,12422,9,,,
31304,18463,12841,17,,,
28446,314,28132,14,,,
29189,5789,23400,15,,,
35342,22343,12999,11,,,
27633,11068,16565,19,,,
28786,8787,19999,18,,,
31637,15482,16155,14,,,
30528,22898,7630,7,,,
23699,12250,11449,20,,,
36544,7036,29508,21,,,
29429,15524,13905,9,,,
27137,1726,25411,12,,,
33284,11272,22012,17,,,
25805,17820,7985,10,,,
31335,1253,30082,21,,,
25395,18373,7022,17,,,
28472,14974,13498,6,,,
27668,21402,6266,20,,,
31661,2477,29184,4,,,
29235,9038,20197,21,,,
25684,9705,15979,13,,,
29543,4386,25157,27,,,
33951,578,33373,8,,,
27685,15248,12437,15,,,
33631,30694,2937,19,,,
23803,14484,9319,14,,,
33123,21517,11606,11,,,
29333,27362,1971,7,,,
30796,12596,18200,13,,,
33975,7052,26923,18,,,
25283,16584,8699,19,,,
25661,22900,2761,14,,,
29761,12643,17118,16,,,
35337,23497,11840,16,,,
31440,26199,5241,15,,,
35960,2884,33076,14,,,
27859,15326,12533,23,,,
32556,19498,13058,23,,,
26072,10398,15674,12,,,
27486,549,26937,11,,,
25171,11766,13405,13,,,
27840,9777,18063,11,,,
31335,12029,19306,7,,,
32967,14183,18784,7,,,
28120,1765,26355,19,,,
27752,15923,11829,11,,,
21617,3686,17931,17,,,
25819,17998,7821,10,,,
27859,1373,26486,18,,,
30095,5592,24503,9,,,
33976,30130,3846,8,,,
35643,15939,19704,13,,,
31215,14008,17207,15,,,
31010,20871,10139,6,,,
29920,21257,8663,12,,,
31911,22963,8948,15,,,
26227,4710,21517,12,,,
35728,17148,18580,15,,,
29761,8350,21411,16,,,
27391,24527,2864,13,,,
31533,30102,1431,18,,,
35591,15196,20395,8,,,
23409,20057,3352,11,,,
21870,2053,19817,14,,,
26079,20173,5906,8,,,
37550,36268,1282,19,,,
23867,19944,3923,13,,,
21845,10434,11411,20,,,
33225,24665,8560,15,,,
22078,20925,1153,19,,,
35937,14268,21669,7,,,
27061,23373,3688,19,,,
23630,5605,18025,13,,,
36119,10600,25519,8,,,
31415,29163,2252,13,,,
27834,16715,11119,21,,,
31790,26483,5307,5,,,
31155,3350,27805,9,,,
29854,27448,2406,8,,,
23773,23309,464,11,,,
31538,29426,2112,18,,,
30803,30521,282,16,,,
23441,17581,5860,13,,,
31913,5127,26786,6,,,
31281,29776,1505,16,,,
31709,23104,8605,11,,,
33237,6849,26388,5,,,
25995,4711,21284,6,,,
31789,4869,26920,12,,,
36039,24582,11457,11,,,
30469,10031,20438,17,,,
27217,16673,10544,19,,,
33415,31087,2328,23,,,
31697,7265,24432,11,,,
32210,25468,6742,10,,,
36079,1054,35025,12,,,
31103,47,31056,18,,,
29711,22465,7246,11,,,
33941,22733,11208,23,,,
31951,14766,17185,16,,,
31404,8308,23096,14,,,
33600,21273,12327,13,,,
23792,21487,2305,18,,,
38043,22386,15657,19,,,
32929,10092,22837,7,,,
34222,20452,13770,8,,,
25757,6579,19178,12,,,
29489,4015,25474,11,,,
33993,30134,3859,15,,,
30870,15223,15647,16,,,
24046,14886,9160,10,,,
29322,7851,21471,13,,,
33377,29379,3998,17,,,
31234,21940,9294,12,,,
33580,20703,12877,9,,,
29660,15098,14562,12,,,
29855,15676,14179,15,,,
26904,10430,16474,11,,,
25696,12021,13675,14,,,
19973,6279,13694,17,,,
24008,14280,9728,11,,,
29251,14384,14867,8,,,
29751,5759,23992,15,,,
21686,11530,10156,9,,,
29596,2918,26678,16,,,
31952,11365,20587,17,,,
25309,18288,7021,16,,,
31696,17126,14570,15,,,
37612,3021,34591,11,,,
32505,32453,52,12,,,
34813,14392,20421,16,,,
28377,25273,3104,27,,,
27877,21398,6479,23,,,
23849,14986,8863,20,,,
27332,5801,21531,6,,,
37330,36464,866,4,,,
27994,17555,10439,15,,,
27507,11969,15538,6,,,
33459,15879,17580,12,,,
31898,26279,5619,7,,,
25793,19958,5835,6,,,
29911,18817,11094,6,,,
25214,11843,13371,5,,,
33503,11263,22240,9,,,
27825,17095,10730,17,,,
27854,309,27545,17,,,
26089,642,25447,15,,,
27400,15447,11953,13,,,
30881,19128,11753,4,,,
30786,30156,630,14,,,
33759,2634,31125,13,,,
31447,3905,27542,10,,,
27381,10831,16550,6,,,
28062,25278,2784,10,,,
33245,9578,23667,14,,,
29323,7651,21672,8,,,
28291,6765,21526,19,,,
22168,19726,2442,7,,,
33663,28580,5083,15,,,
33330,33161,169,15,,,
29188,9474,19714,18,,,
31485,25844,5641,21,,,
33781,19134,14647,19,,,
35700,15871,19829,21,,,
33265,30234,3031,14,,,
30045,27467,2578,12,,,
29325,8646,20679,11,,,
27893,16873,11020,23,,,
19589,17918,1671,24,,,
26063,6287,19776,16,,,
32911,27528,5383,10,,,
23853,17668,6185,9,,,
29106,6072,23034,12,,,
29032,4314,24718,14,,,
25899,13770,12129,16,,,
24973,7362,17611,9,,,
34254,291,33963,18,,,
32360,23670,8690,18,,,
29344,28315,1029,27,,,
26109,19683,6426,8,,,
28146,12381,15765,11,,,
29633,8628,21005,11,,,
19397,1799,17598,14,,,
28070,24915,3155,14,,,
32170,18444,13726,13,,,
33596,33083,513,20,,,
28006,21610,6396,15,,,
33856,13029,20827,10,,,
29763,13206,16557,12,,,
25382,13794,11588,9,,,
31430,9079,22351,11,,,
29846,21017,8829,12,,,
33624,32578,1046,6,,,
25412,13717,11695,17,,,
23605,20057,3548,5,,,
29090,8644,20446,10,,,
28650,20995,7655,11,,,
29836,22050,7786,17,,,
34087,10951,23136,9,,,
38383,31079,7304,18,,,
25924,902,25022,20,,,
29723,12580,17143,11,,,
30909,27188,3721,24,,,
30359,15880,14479,12,,,
33858,25796,8062,16,,,
25478,20585,4893,14,,,
27810,2867,24943,16,,,
35629,28732,6897,6,,,
36833,25050,11783,7,,,
29661,20103,9558,6,,,
23901,19270,4631,12,,,
26085,21719,4366,21,,,
35201,31825,3376,16,,,
35284,18084,17200,9,,,
29158,21106,8052,18,,,
35742,15833,19909,23,,,
27639,8018,19621,6,,,
33718,7285,26433,9,,,
29818,20704,9114,15,,,
33762,21311,12451,12,,,
19949,4239,15710,15,,,
27948,22977,4971,4,,,
31584,9245,22339,7,,,
27981,16734,11247,9,,,
24072,20071,4001,15,,,
34239,23865,10374,18,,,
34115,3066,31049,7,,,
28830,15522,13308,6,,,
33587,28538,5049,16,,,
24169,21592,2577,17,,,
31656,13955,17701,19,,,
29497,13468,16029,16,,,
31800,19123,12677,9,,,
29628,25262,4366,7,,,
31781,17400,14381,24,,,
27379,16324,11055,13,,,
33391,10714,22677,5,,,
29757,11435,18322,14,,,
31252,5851,25401,26,,,
31696,17156,14540,11,,,
37690,4022,33668,17,,,
27398,13232,14166,9,,,
35456,14952,20504,25,,,
36330,12485,23845,10,,,
27870,19429,8441,12,,,
26006,4179,21827,17,,,
35955,15089,20866,8,,,
26896,5188,21708,23,,,
27858,12433,15425,16,,,
33744,12148,21596,25,,,
23857,22283,1574,11,,,
29745,2953,26792,18,,,
28164,14504,13660,16,,,
28344,12349,15995,26,,,
34281,12263,22018,17,,,
29094,9982,19112,17,,,
24198,18068,6130,10,,,
36160,6262,29898,24,,,
27845,10291,17554,21,,,
29616,26570,3046,15,,,
31384,5260,26124,18,,,
29631,21842,7789,14,,,
27700,14753,12947,19,,,
29168,3625,25543,15,,,
32831,23570,9261,19,,,
25561,25291,270,13,,,
32757,4945,27812,19,,,
25330,13907,11423,23,,,
27814,14589,13225,10,,,
30965,18067,12898,25,,,
28092,14359,13733,13,,,
31390,17502,13888,11,,,
27938,2444,25494,18,,,
30153,25245,4908,4,,,
31371,23256,8115,15,,,
19459,289,19170,24,,,
25864,14419,11445,13,,,
31609,19390,12219,6,,,
29502,4678,24824,18,,,
29843,10954,18889,11,,,
29812,22506,7306,13,,,
25888,15263,10625,18,,,
25326,843,24483,14,,,
33137,23664,9473,10,,,
35082,12685,22397,17,,,
36808,25484,11324,19,,,
30280,1188,29092,8,,,
27506,27113,393,17,,,
35501,26239,9262,20,,,
29711,16352,13359,9,,,
29836,13435,16401,5,,,
33979,18596,15383,11,,,
33394,26629,6765,15,,,
29931,12075,17856,7,,,
29848,24552,5296,10,,,
29458,2182,27276,12,,,
25630,11850,13780,19,,,
27554,8243,19311,11,,,
21428,11578,9850,15,,,
37150,26414,10736,12,,,
31840,6179,25661,9,,,
27479,19004,8475,20,,,
35588,4690,30898,15,,,
28952,28274,678,16,,,
33749,15105,18644,24,,,
35320,19503,15817,15,,,
25762,2614,23148,14,,,
29848,5400,24448,21,,,
27325,6059,21266,21,,,
27514,1542,25972,17,,,
31749,10796,20953,4,,,
31766,10229,21537,8,,,
25573,12130,13443,12,,,
31741,29982,1759,8,,,
23831,15162,8669,14,,,
25272,9313,15959,7,,,
31427,8022,23405,5,,,
31018,23772,7246,11,,,
31355,6688,24667,16,,,
29826,11131,18695,6,,,
28013,6298,21715,14,,,
35092,12822,22270,11,,,
31334,14186,17148,17,,,
27858,691,27167,14,,,
32869,25639,7230,9,,,
28067,12612,15455,18,,,
28057,11859,16198,15,,,
27707,24465,3242,16,,,
25585,3688,21897,11,,,
33627,31565,2062,11,,,
33061,1706,31355,11,,,
37246,12075,25171,10,,,
32195,24870,7325,20,,,
35405,29055,6350,11,,,
27754,18981,8773,8,,,
33515,20688,12827,15,,,
23830,3964,19866,13,,,
31612,13020,18592,9,,,
19601,4582,15019,13,,,
23746,9678,14068,17,,,
33038,16042,16996,8,,,
35787,24355,11432,13,,,
29294,2759,26535,15,,,
37605,28144,9461,16,,,
36161,29915,6246,24,,,
26435,18708,7727,15,,,
29797,19837,9960,11,,,
33860,16408,17452,14,,,
27025,22710,4315,21,,,
31747,30549,1198,11,,,
30127,14344,15783,23,,,
33865,28922,4943,4,,,
33668,3530,30138,9,,,
36756,3814,32942,8,,,
29477,24934,4543,14,,,
33491,242,33249,5,,,
31778,29753,2025,10,,,
33101,28105,4996,33,,,
27355,11890,15465,12,,,
23038,9845,13193,3,,,
34288,33379,909,13,,,
21928,10688,11240,16,,,
32105,22735,9370,8,,,
24375,757,23618,12,,,
27867,24891,2976,12,,,
29918,17127,12791,15,,,
40383,38176,2207,9,,,
29424,13767,15657,19,,,
27712,26691,1021,19,,,
28468,22189,6279,10,,,
31621,15111,16510,23,,,
29199,717,28482,22,,,
30934,6811,24123,8,,,
23643,7609,16034,9,,,
31928,15992,15936,10,,,
33138,21957,11181,19,,,
28149,18589,9560,12,,,
29622,28495,1127,9,,,
28126,5471,22655,12,,,
19653,17620,2033,4,,,
25899,13023,12876,12,,,
27757,2855,24902,16,,,
39296,9909,29387,19,,,
35660,24153,11507,17,,,
25633,14547,11086,13,,,
31656,29448,2208,7,,,
29344,25177,4167,22,,,
29430,11490,17940,4,,,
31304,25936,5368,14,,,
33759,30112,3647,8,,,
31341,21643,9698,4,,,
35442,25493,9949,19,,,
29863,16244,13619,17,,,
27194,8853,18341,18,,,
29927,16366,13561,25,,,
29481,7913,21568,12,,,
26030,20010,6020,12,,,
31814,23292,8522,13,,,
29825,7310,22515,6,,,
31857,20618,11239,7,,,
27318,27097,221,23,,,
29470,21109,8361,9,,,
40132,26944,13188,23,,,
30012,24786,5226,12,,,
32963,6110,26853,11,,,
30110,4148,25962,5,,,
30238,23504,6734,19,,,
31079,19190,11889,12,,,
27931,9616,18315,12,,,
26998,15840,11158,11,,,
31951,17161,14790,17,,,
19492,9760,9732,13,,,
29727,562,29165,11,,,
31537,10531,21006,10,,,
31051,16737,14314,10,,,
26026,7484,18542,11,,,
21603,14320,7283,8,,,
35943,17716,18227,11,,,
26725,8487,18238,12,,,
27493,25764,1729,18,,,
33792,7186,26606,30,,,
32871,27633,5238,23,,,
34027,26412,7615,14,,,
27582,13709,13873,11,,,
35374,24460,10914,22,,,
26324,26094,230,8,,,
31002,27615,3387,9,,,
29258,20738,8520,12,,,
29512,8457,21055,17,,,
29484,18902,10582,12,,,
27697,659,27038,14,,,
27054,26306,748,10,,,
35362,30833,4529,24,,,
28201,16282,11919,12,,,
29142,4789,24353,22,,,
19557,2910,16647,23,,,
23488,1490,21998,9,,,
33495,10234,23261,14,,,
27971,13700,14271,18,,,
36921,30577,6344,20,,,
27948,15189,12759,19,,,
25687,18928,6759,10,,,
32985,10229,22756,14,,,
25679,7068,18611,13,,,
19820,12254,7566,14,,,
31912,6638,25274,7,,,
35404,18987,16417,17,,,
37396,6419,30977,10,,,
37463,5137,32326,13,,,
33130,3590,29540,4,,,
33370,19990,13380,27,,,
21652,660,20992,5,,,
32768,13648,19120,14,,,
27707,26428,1279,13,,,
34727,1642,33085,13,,,
29383,28789,594,10,,,
31421,20367,11054,9,,,
33200,1775,31425,19,,,
33558,20286,13272,7,,,
34459,25698,8761,6,,,
33926,7550,26376,23,,,
37490,22265,15225,4,,,
31530,8989,22541,12,,,
35668,19564,16104,19,,,
29692,16522,13170,6,,,
27237,26134,1103,22,,,
29706,6042,23664,10,,,
27408,9076,18332,14,,,
30101,16289,13812,17,,,
32117,28067,4050,10,,,
31999,24015,7984,9,,,
34157,32906,1251,13,,,
23309,4820,18489,10,,,
34181,15437,18744,16,,,
19513,12430,7083,5,,,
27156,18861,8295,23,,,
27814,7022,20792,17,,,
22780,685,22095,9,,,
25083,19480,5603,5,,,
30295,22240,8055,15,,,
25878,19785,6093,22,,,
24807,8197,16610,10,,,
34069,1761,32308,19,,,
25891,7456,18435,24,,,
25919,25036,883,26,,,
31458,18981,12477,16,,,
23917,14085,9832,15,,,
29075,3209,25866,8,,,
21421,9405,12016,24,,,
31725,9048,22677,15,,,
24922,815,24107,10,,,
33755,20541,13214,4,,,
31657,19824,11833,6,,,
28274,11905,16369,10,,,
27114,25637,1477,6,,,
37959,17213,20746,18,,,
33371,26737,6634,8,,,
35693,27783,7910,19,,,
29893,14313,15580,5,,,
31984,3961,28023,7,,,
27540,3878,23662,12,,,
33738,16620,17118,19,,,
31355,23568,7787,13,,,
33814,13997,19817,13,,,
33235,11024,22211,15,,,
38162,13683,24479,20,,,
29868,19487,10381,7,,,
31657,23213,8444,19,,,
27568,5777,21791,15,,,
35715,28197,7518,12,,,
21974,1307,20667,11,,,
26025,16846,9179,23,,,
26154,4946,21208,11,,,
21202,5382,15820,10,,,
34382,9690,24692,11,,,
27371,23674,3697,13,,,
24011,4668,19343,14,,,
25901,25745,156,16,,,
31387,2258,29129,13,,,
28047,5967,22080,15,,,
27642,25083,2559,7,,,
26060,1569,24491,12,,,
30002,17140,12862,6,,,
33434,21310,12124,10,,,
19348,8100,11248,14,,,
33103,20473,12630,10,,,
27502,27286,216,6,,,
29044,26258,2786,10,,,
32944,15191,17753,10,,,
23835,19974,3861,18,,,
37191,32598,4593,9,,,
29705,11491,18214,12,,,
29676,10057,19619,23,,,
31950,31894,56,12,,,
27309,20182,7127,18,,,
29143,4025,25118,17,,,
29252,23641,5611,11,,,
37714,10931,26783,12,,,
37247,33191,4056,10,,,
25957,20104,5853,6,,,
28041,3674,24367,14,,,
29631,10240,19391,19,,,
23998,13200,10798,13,,,
37814,29454,8360,10,,,
35461,9498,25963,17,,,
23604,1905,21699,10,,,
28584,6393,22191,11,,,
34820,9547,25273,12,,,
29816,9780,20036,14,,,
33633,5577,28056,12,,,
27429,20300,7129,17,,,
29865,2414,27451,15,,,
33923,433,33490,11,,,
27326,2693,24633,13,,,
27254,21918,5336,7,,,
29701,20448,9253,13,,,
27846,14830,13016,17,,,
34143,15227,18916,12,,,
25694,577,25117,24,,,
30803,20563,10240,24,,,
23187,6203,16984,11,,,
37311,19891,17420,12,,,
32004,16258,15746,6,,,
35380,33672,1708,16,,,
25286,23449,1837,9,,,
29416,13769,15647,11,,,
27694,10446,17248,15,,,
34904,33580,1324,20,,,
31798,9010,22788,16,,,
29519,11321,18198,14,,,
35440,25629,9811,10,,,
31203,29555,1648,15,,,
29648,172,29476,14,,,
25782,4947,20835,6,,,
21416,16819,4597,4,,,
27438,2375,25063,19,,,
29618,519,29099,8,,,
28984,10791,18193,20,,,
25796,1629,24167,11,,,
31165,27130,4035,14,,,
29719,26375,3344,12,,,
25373,17013,8360,22,,,
29675,3151,26524,15,,,
23653,18236,5417,8,,,
37059,6017,31042,15,,,
27101,14485,12616,24,,,
29263,13991,15272,12,,,
33155,32223,932,16,,,
27796,20572,7224,8,,,
19844,4116,15728,4,,,
30331,7042,23289,18,,,
31352,8069,23283,17,,,
31838,10830,21008,18,,,
28838,28376,462,16,,,
36039,35629,410,10,,,
23982,23799,183,21,,,
25891,16261,9630,5,,,
34029,24719,9310,10,,,
36910,30096,6814,18,,,
23400,23097,303,11,,,
34945,17139,17806,8,,,
31374,21023,10351,15,,,
23299,17089,6210,12,,,
33783,12257,21526,9,,,
36046,18416,17630,14,,,
30975,29053,1922,19,,,
23502,13158,10344,11,,,
29919,19543,10376,16,,,
33403,32763,640,9,,,
29282,28817,465,29,,,
22088,15815,6273,10,,,
31357,22110,9247,22,,,
37338,11159,26179,5,,,
27679,21490,6189,15,,,
24859,2995,21864,10,,,
21881,10476,11405,13,,,
35581,18318,17263,10,,,
25702,5120,20582,13,,,
29718,2372,27346,5,,,
29524,26047,3477,11,,,
27386,25707,1679,12,,,
34021,29923,4098,19,,,
31964,15500,16464,14,,,
34063,26900,7163,21,,,
33630,16198,17432,9,,,
29294,28449,845,16,,,
30073,3765,26308,10,,,
28712,21666,7046,20,,,
30089,5284,24805,17,,,
26510,19840,6670,14,,,
27713,3259,24454,12,,,
22381,2075,20306,14,,,
33065,8174,24891,6,,,
27755,26976,779,9,,,
25569,3840,21729,18,,,
28255,16460,11795,16,,,
25382,22053,3329,10,,,
27576,20997,6579,12,,,
25184,13646,11538,7,,,
26301,22443,3858,9,,,
33226,16203,17023,17,,,
33948,7700,26248,13,,,
25470,3401,22069,18,,,
30883,24719,6164,11,,,
35208,8859,26349,15,,,
34905,27767,7138,10,,,
27726,22999,4727,11,,,
29472,18070,11402,9,,,
23596,8945,14651,31,,,
21993,13378,8615,16,,,
30062,27822,2240,12,,,
32041,12555,19486,16,,,
32381,14155,18226,18,,,
29479,12156,17323,16,,,
24194,11029,13165,27,,,
20966,3279,17687,5,,,
31954,21361,10593,9,,,
28056,11221,16835,10,,,
21059,11258,9801,12,,,
29558,5944,23614,10,,,
31080,26268,4812,16,,,
26094,12594,13500,10,,,
27729,19378,8351,10,,,
33053,8942,24111,10,,,
31085,3455,27630,9,,,
20199,5889,14310,14,,,
29715,14958,14757,16,,,
27152,3109,24043,20,,,
31398,6097,25301,9,,,
29061,18664,10397,18,,,
30893,9405,21488,18,,,
27509,18150,9359,14,,,
25830,14874,10956,9,,,
26033,22955,3078,10,,,
32194,15604,16590,15,,,
30010,20771,9239,5,,,
26238,2846,23392,14,,,
31559,20096,11463,7,,,
29388,9261,20127,7,,,
33679,3504,30175,14,,,
25950,18315,7635,6,,,
36138,25099,11039,12,,,
29693,19712,9981,6,,,
21749,21346,403,11,,,
27494,18415,9079,17,,,
31661,1572,30089,19,,,
27945,14122,13823,6,,,
32247,31624,623,11,,,
38724,17087,21637,17,,,
25628,2937,22691,12,,,
23336,3729,19607,9,,,
29497,940,28557,21,,,
27380,25052,2328,16,,,
34073,22604,11469,15,,,
26115,14658,11457,15,,,
35491,5768,29723,13,,,
37406,27613,9793,12,,,
27940,24875,3065,21,,,
29994,29058,936,22,,,
31649,14742,16907,8,,,
35994,31246,4748,8,,,
35744,31104,4640,14,,,
33532,31428,2104,17,,,
25069,572,24497,12,,,
28530,13698,14832,15,,,
29288,11902,17386,13,,,
21608,16924,4684,8,,,
33845,18500,15345,13,,,
30773,23054,7719,12,,,
33198,12932,20266,10,,,
31164,26255,4909,10,,,
32028,27935,4093,19,,,
27640,18866,8774,16,,,
28206,10426,17780,11,,,
29708,23356,6352,5,,,
31411,19063,12348,5,,,
31540,23963,7577,11,,,
35429,1110,34319,17,,,
29374,7729,21645,27,,,
31910,28866,3044,13,,,
29394,9535,19859,21,,,
31353,19603,11750,18,,,
29188,8405,20783,14,,,
29855,19528,10327,13,,,
27458,18615,8843,19,,,
37537,13600,23937,27,,,
26079,24565,1514,14,,,
29691,10828,18863,14,,,
31233,15651,15582,14,,,
29340,11896,17444,17,,,
31273,20305,10968,10,,,
31512,30738,774,20,,,
32886,1777,31109,16,,,
29151,12334,16817,19,,,
28094,16590,11504,12,,,
25519,10793,14726,15,,,
33347,16640,16707,22,,,
32122,20155,11967,14,,,
33174,12305,20869,10,,,
33787,24781,9006,22,,,
32462,8575,23887,5,,,
26203,22196,4007,9,,,
17541,15655,1886,10,,,
23441,21046,2395,14,,,
25746,20584,5162,6,,,
31476,10872,20604,7,,,
30991,18480,12511,18,,,
29298,9370,19928,5,,,
33662,16246,17416,20,,,
35932,27389,8543,9,,,
32007,8224,23783,22,,,
25235,4861,20374,12,,,
29674,29240,434,22,,,
25515,14956,10559,17,,,
31327,26260,5067,19,,,
27570,22551,5019,11,,,
28688,2312,26376,12,,,
29791,3211,26580,7,,,
28048,16098,11950,21,,,
33473,15435,18038,5,,,
27152,14006,13146,6,,,
28179,24214,3965,9,,,
31660,25166,6494,17,,,
32206,8499,23707,10,,,
29679,25947,3732,12,,,
31432,26001,5431,12,,,
38078,8246,29832,10,,,
25382,14992,10390,9,,,
29564,5585,23979,15,,,
29267,25010,4257,22,,,
37223,5519,31704,13,,,
27465,2058,25407,9,,,
27594,17492,10102,13,,,
29155,15102,14053,20,,,
33097,2906,30191,19,,,
25360,16396,8964,8,,,
31630,3898,27732,13,,,
21696,13791,7905,20,,,
34174,10778,23396,9,,,
37107,24213,12894,14,,,
34344,26532,7812,13,,,
29555,2013,27542,11,,,
35372,28776,6596,16,,,
29590,14477,15113,32,,,
21691,19977,1714,14,,,
30072,2977,27095,18,,,
31408,8756,22652,9,,,
29519,3245,26274,14,,,
31347,9838,21509,6,,,
31399,15917,15482,15,,,
29753,25568,4185,6,,,
33312,4404,28908,14,,,
31433,27468,3965,11,,,
35501,23665,11836,9,,,
23844,7594,16250,5,,,
32220,27562,4658,17,,,
38925,16551,22374,8,,,
31606,2735,28871,14,,,
21805,11003,10802,4,,,
37978,35888,2090,16,,,
35531,2396,33135,6,,,
34091,5523,28568,9,,,
31538,30844,694,26,,,
23525,12211,11314,26,,,
29455,24350,5105,3,,,
32938,19023,13915,17,,,
35530,5798,29732,18,,,
30929,26711,4218,8,,,
37330,11739,25591,13,,,
24114,14328,9786,17,,,
27789,27453,336,18,,,
32010,7800,24210,10,,,
33397,18976,14421,10,,,
29854,25781,4073,5,,,
31707,17606,14101,8,,,
30877,28332,2545,17,,,
32879,11733,21146,6,,,
33385,19716,13669,10,,,
33266,16333,16933,10,,,
28737,4976,23761,7,,,
29820,4675,25145,12,,,
28975,28587,388,9,,,
35698,16792,18906,10,,,
26313,15601,10712,23,,,
24067,5789,18278,12,,,
31043,26216,4827,10,,,
28332,22632,5700,11,,,
31459,29022,2437,12,,,
31579,29564,2015,7,,,
27111,15592,11519,16,,,
31453,15207,16246,18,,,
33633,2650,30983,17,,,
28088,17901,10187,13,,,
23738,13290,10448,9,,,
33806,14714,19092,9,,,
27796,6037,21759,6,,,
25212,14172,11040,9,,,
30476,25409,5067,12,,,
25213,13371,11842,3,,,
27361,21382,5979,20,,,
33727,24859,8868,11,,,
25707,12959,12748,15,,,
26952,8927,18025,18,,,
29511,19614,9897,12,,,
23645,12265,11380,31,,,
25122,9849,15273,13,,,
32267,31762,505,16,,,
26003,21230,4773,24,,,
36361,30070,6291,12,,,
31045,1932,29113,15,,,
26003,22289,3714,20,,,
33788,24676,9112,18,,,
30950,9642,21308,14,,,
31584,16048,15536,14,,,
27321,22159,5162,10,,,
25972,8185,17787,17,,,
27832,6730,21102,17,,,
32215,12059,20156,18,,,
32496,23687,8809,10,,,
33348,12862,20486,12,,,
32083,17896,14187,17,,,
38390,31736,6654,14,,,
28875,18576,10299,17,,,
32148,7630,24518,6,,,
26168,3287,22881,14,,,
27730,3611,24119,14,,,
25367,13916,11451,11,,,
29924,3641,26283,9,,,
24938,12889,12049,19,,,
26865,24375,2490,13,,,
37697,12279,25418,11,,,
31671,9538,22133,10,,,
34039,21568,12471,12,,,
30411,11412,18999,18,,,
33833,8529,25304,25,,,
36957,35513,1444,15,,,
27532,20088,7444,15,,,
21657,12389,9268,14,,,
25841,19269,6572,15,,,
21678,16671,5007,14,,,
29826,24007,5819,16,,,
31683,24074,7609,23,,,
31929,1451,30478,7,,,
29602,12639,16963,11,,,
28943,15735,13208,5,,,
35326,26579,8747,13,,,
34547,30882,3665,10,,,
27319,23647,3672,6,,,
27268,17937,9331,8,,,
26046,25555,491,13,,,
27052,13257,13795,23,,,
31800,17393,14407,3,,,
19199,8447,10752,13,,,
24047,3872,20175,15,,,
31798,5526,26272,11,,,
30021,11102,18919,17,,,
35011,17375,17636,11,,,
30290,12679,17611,15,,,
23231,21013,2218,18,,,
31157,13300,17857,5,,,
29829,19125,10704,13,,,
19535,18429,1106,21,,,
31978,608,31370,5,,,
27501,15136,12365,16,,,
27274,22761,4513,16,,,
27352,5515,21837,14,,,
29419,23085,6334,21,,,
31316,5627,25689,14,,,
35319,23091,12228,6,,,
29981,754,29227,10,,,
30746,28027,2719,13,,,
24088,1918,22170,8,,,
29957,139,29818,10,,,
25879,1224,24655,10,,,
23098,8723,14375,25,,,
29194,15292,13902,10,,,
25283,18525,6758,14,,,
29634,20372,9262,14,,,
25543,5933,19610,26,,,
33498,25090,8408,18,,,
26047,10060,15987,18,,,
25753,22400,3353,10,,,
23409,23329,80,9,,,
29843,10277,19566,29,,,
32053,19166,12887,9,,,
27241,6996,20245,4,,,
32104,19582,12522,14,,,
31764,19474,12290,16,,,
25833,19716,6117,16,,,
29591,20939,8652,13,,,
22068,3325,18743,12,,,
25794,15045,10749,13,,,
23153,3274,19879,6,,,
31387,10858,20529,26,,,
30144,13068,17076,16,,,
23751,3052,20699,23,,,
29215,4180,25035,28,,,
29575,10642,18933,11,,,
27274,17573,9701,16,,,
29780,24953,4827,23,,,
23452,1588,21864,6,,,
25889,1978,23911,11,,,
37435,33162,4273,7,,,
27456,6897,20559,14,,,
29893,28962,931,14,,,
31826,18645,13181,10,,,
22123,1591,20532,14,,,
27994,9127,18867,12,,,
33476,18568,14908,12,,,
27492,13597,13895,11,,,
31133,2294,28839,11,,,
25898,11345,14553,10,,,
19416,6060,13356,7,,,
23287,11487,11800,5,,,
29877,27063,2814,14,,,
33842,13139,20703,27,,,
27323,4969,22354,5,,,
26443,18059,8384,20,,,
29530,27398,2132,19,,,
29650,12627,17023,22,,,
29292,10796,18496,9,,,
27146,22614,4532,9,,,
29647,25148,4499,23,,,
34057,31970,2087,11,,,
35283,1514,33769,19,,,
21759,3924,17835,20,,,
27634,14051,13583,16,,,
37424,30715,6709,23,,,
33584,12569,21015,7,,,
32076,29598,2478,7,,,
33197,30799,2398,10,,,
28029,9143,18886,13,,,
35883,22726,13157,13,,,
32186,26559,5627,17,,,
29763,23665,6098,10,,,
27869,23224,4645,13,,,
35557,9654,25903,12,,,
29986,13636,16350,6,,,
33860,15342,18518,10,,,
34003,26571,7432,14,,,
27211,24920,2291,7,,,
32019,21331,10688,14,,,
25706,17281,8425,17,,,
25868,9061,16807,7,,,
35200,34414,786,7,,,
27578,27063,515,13,,,
29364,3415,25949,6,,,
29569,4153,25416,8,,,
27408,13317,14091,17,,,
29484,2015,27469,17,,,
26080,5209,20871,11,,,
33609,21172,12437,9,,,
35292,24038,11254,13,,,
34011,22264,11747,10,,,
29311,11658,17653,22,,,
35465,28972,6493,10,,,
29932,1796,28136,10,,,
28836,10009,18827,14,,,
34544,23281,11263,13,,,
33918,224,33694,22,,,
23186,14087,9099,8,,,
33380,10507,22873,15,,,
31945,26807,5138,7,,,
31603,22272,9331,14,,,
33175,13069,20106,12,,,
29271,24708,4563,20,,,
31246,4933,26313,13,,,
25483,12361,13122,17,,,
25230,21445,3785,16,,,
32191,11289,20902,18,,,
27053,17046,10007,15,,,
31060,5101,25959,11,,,
33361,29849,3512,15,,,
31471,23397,8074,16,,,
25464,10095,15369,7,,,
27691,11449,16242,19,,,
35378,25787,9591,6,,,
29076,13551,15525,10,,,
34024,10999,23025,13,,,
38211,6618,31593,23,,,
37616,7785,29831,12,,,
31622,219,31403,7,,,
33419,25100,8319,10,,,
28250,1301,26949,15,,,
33608,7127,26481,18,,,
27948,14940,13008,19,,,
37853,5886,31967,21,,,
27943,8929,19014,11,,,
35088,1569,33519,22,,,
32146,22848,9298,5,,,
34042,3535,30507,11,,,
25133,13586,11547,18,,,
32155,9299,22856,25,,,
31527,16899,14628,12,,,
33536,29788,3748,11,,,
34023,18700,15323,8,,,
29795,29299,496,20,,,
31902,14539,17363,15,,,
33221,23292,9929,10,,,
25609,10148,15461,19,,,
35240,19916,15324,16,,,
24974,8680,16294,9,,,
33088,3141,29947,11,,,
31574,28018,3556,17,,,
31598,24316,7282,14,,,
29221,25276,3945,12,,,
23654,4166,19488,17,,,
27328,18485,8843,6,,,
29994,16158,13836,12,,,
27976,9578,18398,19,,,
29140,27163,1977,7,,,
33483,8079,25404,14,,,
31230,15275,15955,4,,,
27343,14819,12524,16,,,
27229,17929,9300,18,,,
40633,19566,21067,12,,,
31699,16869,14830,9,,,
31986,8505,23481,14,,,
27816,7073,20743,11,,,
24147,10341,13806,14,,,
25719,19084,6635,22,,,
27446,9088,18358,6,,,
34474,28011,6463,15,,,
37607,18652,18955,11,,,
29849,3502,26347,19,,,
29388,13641,15747,8,,,
28302,19859,8443,9,,,
22878,13664,9214,10,,,
29704,4026,25678,17,,,
31506,10902,20604,14,,,
29948,20792,9156,8,,,
23081,12395,10686,17,,,
22843,5421,17422,14,,,
21818,18327,3491,15,,,
33693,23361,10332,10,,,
35557,16622,18935,25,,,
29993,26610,3383,15,,,
27227,21459,5768,18,,,
37403,36986,417,16,,,
28991,8650,20341,5,,,
29405,17200,12205,18,,,
28347,844,27503,19,,,
29222,8747,20475,8,,,
29410,5094,24316,6,,,
29482,21037,8445,14,,,
21817,8603,13214,12,,,
35370,31177,4193,9,,,
24962,15138,9824,6,,,
30128,10212,19916,12,,,
23941,1596,22345,11,,,
25507,4402,21105,10,,,
37362,1177,36185,16,,,
31615,18273,13342,17,,,
38399,17273,21126,12,,,
34170,6504,27666,6,,,
35998,26838,9160,10,,,
31342,26614,4728,17,,,
33153,29257,3896,12,,,
27919,438,27481,11,,,
36197,28137,8060,13,,,
33470,17593,15877,4,,,
25813,7017,18796,11,,,
27990,12212,15778,19,,,
19399,3922,15477,11,,,
33458,19513,13945,6,,,
27490,10144,17346,12,,,
31766,8893,22873,11,,,
31947,12797,19150,21,,,
24243,11011,13232,13,,,
31317,12828,18489,11,,,
27525,26077,1448,7,,,
25314,7502,17812,5,,,
29918,3132,26786,19,,,
27421,2647,24774,16,,,
29772,29712,60,5,,,
25344,24255,1089,5,,,
26914,20931,5983,9,,,
33678,4867,28811,11,,,
32902,25594,7308,11,,,
35705,231,35474,7,,,
37625,29711,7914,15,,,
33933,23706,10227,10,,,
31557,15385,16172,15,,,
27926,10892,17034,10,,,
36361,35020,1341,12,,,
21452,14261,7191,12,,,
27214,8069,19145,12,,,
19816,17727,2089,21,,,
30102,4979,25123,17,,,
27498,23812,3686,15,,,
30412,27813,2599,15,,,
25967,20645,5322,10,,,
27704,23216,4488,14,,,
33061,7047,26014,8,,,
30761,4081,26680,15,,,
30380,5520,24860,12,,,
36403,15767,20636,10,,,
34689,22057,12632,12,,,
34437,31848,2589,21,,,
27700,8774,18926,9,,,
29052,7882,21170,13,,,
31869,15867,16002,11,,,
37593,4299,33294,14,,,
25940,4008,21932,9,,,
31462,31198,264,12,,,
20073,7419,12654,13,,,
27976,15217,12759,24,,,
29745,13371,16374,31,,,
29730,14308,15422,14,,,
27608,10616,16992,22,,,
33901,33851,50,8,,,
29813,12564,17249,17,,,
26125,10591,15534,25,,,
31818,27385,4433,19,,,
31715,22011,9704,17,,,
25573,394,25179,13,,,
30036,8963,21073,13,,,
37683,36257,1426,19,,,
22390,3311,19079,27,,,
31012,2320,28692,17,,,
27346,5498,21848,7,,,
29408,3629,25779,17,,,
29393,5971,23422,9,,,
21468,20909,559,10,,,
35629,1270,34359,12,,,
27750,26833,917,10,,,
30884,22440,8444,15,,,
20157,6530,13627,10,,,
27257,24278,2979,7,,,
33710,27496,6214,17,,,
25620,136,25484,13,,,
31430,7975,23455,7,,,
21747,15266,6481,14,,,
32140,13007,19133,15,,,
29117,7527,21590,29,,,
33419,10207,23212,10,,,
30532,29544,988,13,,,
27134,8498,18636,14,,,
27138,1033,26105,14,,,
25733,19912,5821,14,,,
26971,15418,11553,22,,,
29758,19255,10503,9,,,
31973,30513,1460,27,,,
34105,30351,3754,18,,,
25501,17152,8349,15,,,
33652,22043,11609,4,,,
27307,23183,4124,9,,,
27453,9806,17647,21,,,
36511,32226,4285,14,,,
29207,26925,2282,9,,,
29669,2957,26712,17,,,
23913,8080,15833,18,,,
35004,25319,9685,17,,,
23981,14450,9531,17,,,
36043,25662,10381,12,,,
30111,4689,25422,18,,,
31314,22081,9233,11,,,
28332,22965,5367,12,,,
29587,14331,15256,14,,,
37362,12149,25213,5,,,
28553,20934,7619,16,,,
29760,20428,9332,14,,,
34094,15764,18330,10,,,
25759,20653,5106,11,,,
33772,23486,10286,16,,,
33622,1176,32446,12,,,
35526,26130,9396,8,,,
29841,18626,11215,11,,,
26221,15310,10911,11,,,
19994,16953,3041,11,,,
29634,5845,23789,17,,,
25623,7732,17891,14,,,
29815,22079,7736,18,,,
29676,4162,25514,10,,,
39594,14123,25471,11,,,
33893,30939,2954,13,,,
31506,14608,16898,14,,,
23284,387,22897,12,,,
29658,12459,17199,6,,,
27732,12193,15539,12,,,
21974,20497,1477,15,,,
31412,28865,2547,13,,,
30287,1688,28599,15,,,
34115,5313,28802,11,,,
24217,19466,4751,12,,,
21965,670,21295,13,,,
31136,6171,24965,17,,,
23457,11828,11629,15,,,
29854,29247,607,35,,,
29435,481,28954,13,,,
29227,14128,15099,5,,,
26320,18007,8313,16,,,
32031,25043,6988,6,,,
25823,19449,6374,13,,,
29749,23295,6454,16,,,
34141,13434,20707,9,,,
29451,28726,725,9,,,
29762,29586,176,19,,,
33182,31597,1585,20,,,
34647,6402,28245,14,,,
34487,21641,12846,9,,,
33433,12163,21270,17,,,
33827,10377,23450,7,,,
26368,16032,10336,20,,,
25828,22288,3540,13,,,
35521,32441,3080,9,,,
33701,24468,9233,5,,,
32819,9664,23155,6,,,
33081,5517,27564,9,,,
33444,29309,4135,19,,,
21781,300,21481,16,,,
31579,8341,23238,21,,,
25029,24819,210,21,,,
27071,3248,23823,13,,,
36209,20436,15773,13,,,
29149,21561,7588,13,,,
27690,23883,3807,30,,,
31517,11301,20216,9,,,
27629,27066,563,13,,,
24095,19072,5023,14,,,
27845,16871,10974,17,,,
33566,28322,5244,12,,,
38919,26183,12736,7,,,
37824,16819,21005,14,,,
22920,2536,20384,14,,,
33450,12915,20535,22,,,
33710,9511,24199,22,,,
26133,8061,18072,8,,,
25959,3947,22012,10,,,
33446,28266,5180,8,,,
22649,6289,16360,11,,,
34720,17554,17166,11,,,
31177,26468,4709,14,,,
29020,15943,13077,18,,,
35084,27530,7554,7,,,
25265,8446,16819,16,,,
25674,20689,4985,18,,,
31681,28549,3132,8,,,
25390,18129,7261,12,,,
25840,6807,19033,17,,,
33549,32549,1000,21,,,
26784,25333,1451,17,,,
35288,3546,31742,17,,,
27904,2649,25255,15,,,
32937,15273,17664,10,,,
35046,20761,14285,15,,,
33834,17153,16681,22,,,
25366,10588,14778,5,,,
31610,13857,17753,10,,,
29330,5009,24321,12,,,
31218,26410,4808,10,,,
29738,1608,28130,18,,,
33404,24324,9080,14,,,
29406,24611,4795,4,,,
25655,4508,21147,19,,,
23866,7844,16022,6,,,
21012,2698,18314,15,,,
32133,18137,13996,13,,,
31407,24249,7158,10,,,
29624,18247,11377,11,,,
29527,22830,6697,9,,,
33212,18919,14293,10,,,
31514,22309,9205,19,,,
28093,11204,16889,8,,,
27922,17430,10492,17,,,
29894,28979,915,17,,,
33257,21095,12162,10,,,
29658,20510,9148,7,,,
23831,9937,13894,12,,,
29475,2710,26765,20,,,
29078,28349,729,12,,,
29116,24635,4481,14,,,
31258,20737,10521,11,,,
31802,25583,6219,7,,,
29947,2127,27820,18,,,
23843,21072,2771,16,,,
27418,9794,17624,6,,,
27530,20565,6965,12,,,
29602,15872,13730,16,,,
33350,26369,6981,13,,,
29515,18524,10991,23,,,
31915,19233,12682,13,,,
33673,19295,14378,16,,,
39369,9647,29722,5,,,
25471,7800,17671,12,,,
33331,32656,675,10,,,
23616,22198,1418,21,,,
37966,2773,35193,16,,,
34237,20538,13699,14,,,
35255,29497,5758,9,,,
29886,1828,28058,14,,,
31309,9512,21797,16,,,
23603,15494,8109,20,,,
21501,10568,10933,5,,,
33509,11533,21976,12,,,
27328,2193,25135,9,,,
25627,11827,13800,11,,,
32321,30245,2076,8,,,
37348,35595,1753,9,,,
19735,10092,9643,5,,,
27565,18454,9111,17,,,
31579,28581,2998,6,,,
31191,14290,16901,13,,,
24090,2409,21681,16,,,
35740,1440,34300,11,,,
31470,28493,2977,17,,,
29466,25729,3737,7,,,
37336,14821,22515,10,,,
31921,20891,11030,5,,,
29953,10031,19922,9,,,
31843,8019,23824,14,,,
27209,15902,11307,16,,,
34214,13960,20254,4,,,
35437,22885,12552,8,,,
32292,5649,26643,17,,,
29426,27893,1533,15,,,
25936,14613,11323,4,,,
24002,12867,11135,10,,,
33556,2094,31462,16,,,
23631,11467,12164,13,,,
31917,4493,27424,15,,,
23830,13564,10266,25,,,
27355,7837,19518,16,,,
33044,4639,28405,12,,,
27583,11187,16396,12,,,
39449,17780,21669,16,,,
25302,21543,3759,13,,,
30139,19373,10766,18,,,
31331,5416,25915,18,,,
21640,7945,13695,12,,,
32618,31459,1159,14,,,
28091,5644,22447,12,,,
36075,35726,349,22,,,
38886,15159,23727,16,,,
33587,6824,26763,14,,,
29441,18196,11245,11,,,
30052,14250,15802,10,,,
27075,21171,5904,14,,,
36175,1240,34935,22,,,
28157,16338,11819,12,,,
29862,4404,25458,8,,,
27706,1833,25873,14,,,
35854,25211,10643,19,,,
23867,12081,11786,26,,,
26138,8137,18001,11,,,
26050,22686,3364,21,,,
21444,16125,5319,7,,,
27588,8626,18962,7,,,
35066,24205,10861,20,,,
29258,6590,22668,11,,,
30140,14443,15697,30,,,
33835,8582,25253,9,,,
21420,10715,10705,8,,,
35995,16692,19303,6,,,
24981,11555,13426,20,,,
33329,32065,1264,10,,,
33918,14790,19128,21,,,
29089,5507,23582,13,,,
27775,5358,22417,15,,,
29601,15389,14212,5,,,
25382,7399,17983,15,,,
31483,25853,5630,5,,,
33180,18308,14872,15,,,
23668,2039,21629,9,,,
22314,10697,11617,15,,,
21758,18925,2833,13,,,
29907,7814,22093,6,,,
32025,26744,5281,13,,,
29153,23844,5309,13,,,
27893,14375,13518,9,,,
35889,3751,32138,8,,,
31924,19165,12759,9,,,
29433,8757,20676,6,,,
24236,10365,13871,9,,,
28550,17390,11160,13,,,
31428,27676,3752,8,,,
27788,26805,983,15,,,
22080,15223,6857,16,,,
27217,23491,3726,8,,,
31446,5838,25608,18,,,
25726,10364,15362,23,,,
33089,726,32363,13,,,
27432,13150,14282,16,,,
27931,22101,5830,5,,,
29284,24546,4738,12,,,
33647,182,33465,9,,,
34081,9829,24252,17,,,
29830,823,29007,21,,,
23605,16713,6892,11,,,
35645,21725,13920,9,,,
28218,22313,5905,21,,,
31079,17437,13642,14,,,
33591,16207,17384,10,,,
25314,2891,22423,23,,,
29501,16768,12733,11,,,
28892,14550,14342,7,,,
29432,11926,17506,8,,,
31738,19163,12575,7,,,
29653,18432,11221,7,,,
29321,25360,3961,5,,,
25577,20027,5550,14,,,
27147,27005,142,5,,,
29568,2958,26610,27,,,
21584,18219,3365,14,,,
31056,6139,24917,14,,,
34118,107,34011,13,,,
29968,23716,6252,14,,,
27610,10561,17049,13,,,
29332,16363,12969,9,,,
31719,31716,3,14,,,
27731,17078,10653,23,,,
24323,10864,13459,7,,,
31386,6599,24787,14,,,
28821,25571,3250,15,,,
23787,12456,11331,18,,,
21732,3664,18068,15,,,
31302,25093,6209,15,,,
35739,22349,13390,7,,,
23491,9224,14267,9,,,
28121,22596,5525,9,,,
34056,17436,16620,10,,,
33225,3810,29415,14,,,
31965,11209,20756,15,,,
30821,21274,9547,18,,,
31783,16847,14936,6,,,
33653,198,33455,20,,,
29163,7554,21609,20,,,
31769,21051,10718,7,,,
27057,23384,3673,11,,,
25602,25402,200,11,,,
30272,9914,20358,11,,,
27389,16694,10695,20,,,
29465,26129,3336,12,,,
32389,26726,5663,14,,,
31094,28333,2761,10,,,
33945,9150,24795,10,,,
31277,29180,2097,14,,,
30804,19929,10875,19,,,
29594,13595,15999,10,,,
27577,13285,14292,18,,,
29156,10527,18629,8,,,
35764,28829,6935,8,,,
25822,7380,18442,7,,,
25910,24451,1459,15,,,
35194,19326,15868,11,,,
27177,21693,5484,15,,,
26094,5569,20525,12,,,
31227,8574,22653,23,,,
31443,10689,20754,18,,,
27738,7849,19889,13,,,
33573,10790,22783,28,,,
27285,10093,17192,16,,,
35836,32271,3565,13,,,
27939,6318,21621,11,,,
30818,1807,29011,10,,,
30995,23256,7739,18,,,
27037,9512,17525,10,,,
37408,24636,12772,9,,,
23154,3319,19835,14,,,
25325,21788,3537,20,,,
31294,21976,9318,12,,,
27737,21471,6266,7,,,
29625,2532,27093,10,,,
30455,24269,6186,10,,,
31221,25016,6205,15,,,
27886,12769,15117,12,,,
29407,14606,14801,15,,,
27378,15018,12360,15,,,
35608,14733,20875,23,,,
35288,16174,19114,13,,,
36062,29442,6620,8,,,
28272,24743,3529,10,,,
25306,23426,1880,9,,,
25730,12525,13205,8,,,
28074,23339,4735,16,,,
21472,15111,6361,23,,,
28927,23375,5552,20,,,
30833,20335,10498,18,,,
29666,23756,5910,24,,,
29774,26436,3338,21,,,
31691,26769,4922,17,,,
23904,5214,18690,5,,,
31661,28153,3508,15,,,
27547,6299,21248,21,,,
27672,14056,13616,14,,,
29778,20187,9591,5,,,
34059,24305,9754,12,,,
29102,22080,7022,13,,,
29874,9133,20741,2,,,
27257,22338,4919,5,,,
27281,23326,3955,14,,,
22444,18881,3563,10,,,
28342,16905,11437,17,,,
29672,12318,17354,11,,,
25886,13092,12794,13,,,
32009,10107,21902,10,,,
27075,9656,17419,11,,,
33688,19975,13713,18,,,
31697,24478,7219,14,,,
27506,4173,23333,2,,,
26303,9108,17195,3,,,
35992,9429,26563,10,,,
22049,12151,9898,9,,,
31274,5293,25981,16,,,
29971,3612,26359,7,,,
21611,19372,2239,15,,,
36988,10724,26264,18,,,
29246,17098,12148,13,,,
27386,7948,19438,11,,,
31361,28047,3314,15,,,
31891,1040,30851,14,,,
20882,13470,7412,17,,,
29376,1883,27493,17,,,
29322,20495,8827,23,,,
29366,27411,1955,6,,,
21149,13439,7710,8,,,
31730,30092,1638,15,,,
29930,26757,3173,18,,,
23564,12929,10635,17,,,
30295,11488,18807,20,,,
31554,23657,7897,3,,,
35236,7228,28008,15,,,
29855,1999,27856,20,,,
17841,8080,9761,15,,,
30073,3225,26848,5,,,
30626,21558,9068,14,,,
31469,12806,18663,17,,,
33372,22296,11076,15,,,
28096,6869,21227,6,,,
27888,14405,13483,13,,,
27594,7746,19848,9,,,
35604,14628,20976,10,,,
35057,20900,14157,17,,,
25567,1928,23639,19,,,
24132,7723,16409,13,,,
31116,6626,24490,14,,,
27277,10833,16444,25,,,
19849,19558,291,10,,,
31633,21561,10072,15,,,
27387,26337,1050,14,,,
29882,14455,15427,18,,,
35803,3320,32483,12,,,
29659,10886,18773,15,,,
29851,23335,6516,14,,,
37365,27481,9884,17,,,
36973,35679,1294,5,,,
34151,6469,27682,7,,,
33162,27868,5294,24,,,
31616,23243,8373,12,,,
31313,14859,16454,16,,,
28014,22627,5387,24,,,
29370,3632,25738,20,,,
27144,12170,14974,16,,,
29280,26961,2319,11,,,
34849,18891,15958,14,,,
31919,22002,9917,17,,,
29705,10908,18797,21,,,
31935,4923,27012,17,,,
33137,3487,29650,22,,,
27219,7318,19901,11,,,
31570,12186,19384,9,,,
33737,10594,23143,13,,,
27353,23573,3780,29,,,
23414,6118,17296,14,,,
29973,34,29939,23,,,
26000,20498,5502,23,,,
31049,12244,18805,8,,,
29574,10852,18722,8,,,
29302,21417,7885,11,,,
28894,7210,21684,11,,,
37101,1490,35611,13,,,
23373,12597,10776,21,,,
25060,13696,11364,18,,,
34150,5791,28359,25,,,
24747,18084,6663,6,,,
32113,11661,20452,10,,,
31335,865,30470,14,,,
22181,15436,6745,12,,,
30258,29884,374,16,,,
31274,16639,14635,6,,,
31713,5807,25906,13,,,
33638,30374,3264,5,,,
25789,24333,1456,11,,,
30053,21949,8104,20,,,
29105,1349,27756,29,,,
37297,34577,2720,7,,,
27476,7353,20123,5,,,
26835,12059,14776,9,,,
31605,23016,8589,9,,,
28044,17905,10139,10,,,
31649,28673,2976,14,,,
29427,14528,14899,13,,,
23781,10160,13621,11,,,
30130,24448,5682,14,,,
29872,7635,22237,16,,,
39134,27582,11552,4,,,
36423,18625,17798,4,,,
39854,23862,15992,29,,,
31624,5575,26049,9,,,
33675,10705,22970,5,,,
20064,13751,6313,15,,,
23675,15791,7884,10,,,
32154,25333,6821,15,,,
21160,11296,9864,31,,,
31053,17535,13518,10,,,
28776,13121,15655,9,,,
23559,14967,8592,25,,,
27623,25666,1957,13,,,
31549,30657,892,17,,,
32052,11638,20414,16,,,
24449,8146,16303,18,,,
32000,2727,29273,6,,,
29577,3545,26032,17,,,
29013,11679,17334,14,,,
33785,20480,13305,3,,,
32824,30160,2664,19,,,
34937,13852,21085,15,,,
31209,21761,9448,10,,,
29079,22439,6640,6,,,
31636,25806,5830,5,,,
35751,6179,29572,19,,,
29594,8068,21526,17,,,
25858,11406,14452,17,,,
33262,18432,14830,8,,,
22942,22037,905,14,,,
27613,6818,20795,5,,,
27267,1299,25968,20,,,
28105,10198,17907,7,,,
26115,540,25575,14,,,
25840,742,25098,14,,,
23745,17208,6537,19,,,
27615,6856,20759,12,,,
27612,11201,16411,12,,,
21830,1851,19979,13,,,
31823,23737,8086,9,,,
28924,17806,11118,11,,,
27609,23975,3634,12,,,
22929,20227,2702,6,,,
27939,24633,3306,19,,,
31073,3741,27332,13,,,
29719,5578,24141,10,,,
27748,6793,20955,8,,,
27152,6480,20672,10,,,
30662,9097,21565,10,,,
35645,5386,30259,13,,,
19562,9823,9739,11,,,
33684,14099,19585,12,,,
31881,17009,14872,14,,,
27855,20318,7537,4,,,
21956,8345,13611,7,,,
35385,14217,21168,21,,,
38055,6263,31792,4,,,
26748,671,26077,22,,,
29647,18323,11324,12,,,
25980,22773,3207,14,,,
25289,8281,17008,5,,,
27511,11057,16454,5,,,
29921,20637,9284,18,,,
27992,13065,14927,13,,,
29738,23313,6425,7,,,
33220,1697,31523,27,,,
34117,5569,28548,13,,,
26047,25132,915,17,,,
33695,4680,29015,8,,,
28158,24699,3459,24,,,
27071,14840,12231,13,,,
27313,17857,9456,17,,,
27827,23733,4094,9,,,
33859,23076,10783,23,,,
30561,21041,9520,15,,,
27742,946,26796,9,,,
31550,24100,7450,16,,,
27797,24926,2871,22,,,
27213,5371,21842,9,,,
29779,5428,24351,10,,,
27805,18118,9687,17,,,
29087,19467,9620,21,,,
33542,25535,8007,9,,,
29420,11716,17704,18,,,
36481,30843,5638,9,,,
35341,13593,21748,10,,,
24281,11428,12853,19,,,
29564,8595,20969,22,,,
34296,12233,22063,17,,,
29154,14619,14535,12,,,
30844,25247,5597,18,,,
17211,11797,5414,19,,,
19983,11660,8323,11,,,
25726,8533,17193,16,,,
23261,12756,10505,13,,,
25690,11455,14235,12,,,
25628,24347,1281,22,,,
35407,30736,4671,17,,,
30851,15566,15285,25,,,
23440,5556,17884,11,,,
26052,25451,601,19,,,
31897,640,31257,25,,,
33491,25683,7808,11,,,
35374,5055,30319,3,,,
34005,10666,23339,8,,,
27625,23435,4190,13,,,
28112,4596,23516,13,,,
31164,19218,11946,15,,,
27491,23963,3528,13,,,
33979,26202,7777,17,,,
31791,1778,30013,9,,,
31406,4837,26569,8,,,
31324,15061,16263,5,,,
32964,10381,22583,12,,,
26077,21823,4254,8,,,
29728,1775,27953,9,,,
31169,22748,8421,15,,,
28745,18179,10566,11,,,
33620,297,33323,19,,,
27674,26995,679,20,,,
25471,20860,4611,19,,,
31071,3536,27535,13,,,
35590,34278,1312,16,,,
31070,30051,1019,16,,,
21133,16864,4269,11,,,
34368,26601,7767,19,,,
30976,14965,16011,9,,,
32515,31737,778,20,,,
27269,12739,14530,10,,,
25902,25478,424,6,,,
33581,27081,6500,6,,,
33477,7496,25981,26,,,
26640,5335,21305,13,,,
23058,14783,8275,7,,,
33486,22511,10975,17,,,
33774,590,33184,12,,,
29323,2473,26850,13,,,
26827,24880,1947,7,,,
33693,33449,244,14,,,
21296,2720,18576,20,,,
29645,9020,20625,16,,,
23428,19217,4211,22,,,
27880,3436,24444,24,,,
30336,559,29777,17,,,
31395,16224,15171,10,,,
33675,28715,4960,12,,,
31050,265,30785,10,,,
29691,8428,21263,16,,,
27929,1968,25961,12,,,
31510,14442,17068,10,,,
30017,23917,6100,4,,,
29803,20027,9776,23,,,
29478,11239,18239,10,,,
32248,1615,30633,19,,,
21541,16292,5249,24,,,
25900,573,25327,13,,,
33961,4139,29822,15,,,
27732,10664,17068,18,,,
35954,2093,33861,12,,,
33999,2929,31070,12,,,
27749,1405,26344,10,,,
21390,8114,13276,9,,,
26224,16401,9823,9,,,
28979,25817,3162,9,,,
29266,9039,20227,19,,,
23761,8135,15626,6,,,
34457,15198,19259,18,,,
30075,5281,24794,15,,,
29359,12858,16501,8,,,
25376,23470,1906,13,,,
29542,11462,18080,13,,,
25265,2479,22786,21,,,
29044,21589,7455,22,,,
33646,19080,14566,7,,,
27513,27468,45,9,,,
29356,337,29019,10,,,
30080,26033,4047,12,,,
29793,5218,24575,17,,,
27945,13083,14862,20,,,
31737,21413,10324,19,,,
31884,20797,11087,3,,,
33255,10797,22458,12,,,
35130,7497,27633,5,,,
33723,28205,5518,22,,,
23175,8277,14898,17,,,
28051,2593,25458,22,,,
30265,8265,22000,13,,,
32219,20117,12102,16,,,
25165,6079,19086,10,,,
32075,26043,6032,9,,,
33557,16559,16998,17,,,
31322,27218,4104,7,,,
31992,31522,470,20,,,
31890,7468,24422,11,,,
27323,18152,9171,23,,,
25665,11949,13716,6,,,
31188,9575,21613,9,,,
23804,23320,484,10,,,
37571,25230,12341,25,,,
27772,2310,25462,8,,,
21856,330,21526,9,,,
21785,5418,16367,6,,,
31502,29435,2067,12,,,
31086,30739,347,17,,,
24242,13641,10601,15,,,
28063,4360,23703,5,,,
37396,26941,10455,12,,,
19718,5627,14091,11,,,
29388,19169,10219,9,,,
23902,14984,8918,31,,,
29854,18245,11609,16,,,
37194,33639,3555,19,,,
22098,20763,1335,17,,,
27703,9062,18641,13,,,
29500,8058,21442,12,,,
36974,25274,11700,18,,,
36418,29512,6906,8,,,
29895,19938,9957,16,,,
35598,1635,33963,15,,,
29401,5020,24381,7,,,
31562,26632,4930,14,,,
29865,18364,11501,19,,,
37358,33946,3412,11,,,
29992,26888,3104,15,,,
33631,13968,19663,7,,,
29943,11118,18825,14,,,
37609,25793,11816,13,,,
27880,8545,19335,6,,,
31412,14959,16453,15,,,
31707,9225,22482,17,,,
31792,14580,17212,23,,,
29320,18844,10476,13,,,
29835,20479,9356,6,,,
19912,12509,7403,16,,,
19682,1765,17917,7,,,
21648,12099,9549,9,,,
26491,22010,4481,11,,,
29558,26073,3485,11,,,
25721,9202,16519,11,,,
27543,23377,4166,7,,,
27786,25591,2195,18,,,
30893,861,30032,17,,,
33771,23560,10211,9,,,
25203,5074,20129,8,,,
29384,2063,27321,23,,,
26061,12150,13911,10,,,
29304,24898,4406,12,,,
17205,14828,2377,25,,,
35312,5042,30270,22,,,
25372,20935,4437,14,,,
28222,16613,11609,15,,,
33930,14323,19607,7,,,
23724,23277,447,15,,,
38091,27697,10394,16,,,
32270,17243,15027,8,,,
20100,10608,9492,8,,,
31481,20870,10611,16,,,
21703,12200,9503,23,,,
31678,28894,2784,22,,,
29892,14393,15499,12,,,
18029,3112,14917,23,,,
30305,17320,12985,9,,,
28133,8045,20088,15,,,
31589,25307,6282,12,,,
29470,26020,3450,10,,,
31799,10831,20968,14,,,
31615,27330,4285,8,,,
39053,22005,17048,11,,,
37088,13911,23177,20,,,
30899,18277,12622,23,,,
25546,22884,2662,5,,,
29377,26284,3093,7,,,
33616,19987,13629,10,,,
38188,4530,33658,16,,,
32946,19376,13570,12,,,
27127,25658,1469,8,,,
23580,14383,9197,10,,,
23086,5290,17796,18,,,
23772,17105,6667,10,,,
31905,869,31036,15,,,
28873,5971,22902,14,,,
21433,11217,10216,11,,,
27751,3801,23950,13,,,
33469,15257,18212,8,,,
27360,11178,16182,13,,,
29238,21420,7818,9,,,
30406,28673,1733,13,,,
21922,10579,11343,16,,,
27616,16087,11529,18,,,
31715,21221,10494,11,,,
29595,7065,22530,7,,,
33308,29839,3469,14,,,
27691,8399,19292,6,,,
22947,18951,3996,24,,,
31731,25898,5833,16,,,
31764,1840,29924,13,,,
25803,21937,3866,17,,,
28166,13845,14321,27,,,
28246,24504,3742,18,,,
29495,24426,5069,16,,,
33029,11656,21373,20,,,
31410,22515,8895,9,,,
31508,4570,26938,22,,,
24136,13006,11130,18,,,
31254,30702,552,11,,,
31447,16396,15051,16,,,
34452,1200,33252,14,,,
29633,16955,12678,15,,,
29768,23303,6465,9,,,
31510,5062,26448,8,,,
35371,22968,12403,11,,,
25421,6454,18967,27,,,
35736,30116,5620,6,,,
34340,8617,25723,14,,,
27268,21569,5699,21,,,
28827,4300,24527,14,,,
27314,19563,7751,15,,,
29884,29089,795,20,,,
25641,1934,23707,20,,,
33465,21485,11980,10,,,
28222,2763,25459,13,,,
33824,25648,8176,10,,,
29146,24303,4843,15,,,
29731,2488,27243,17,,,
23902,19939,3963,13,,,
23581,16823,6758,16,,,
29816,19529,10287,15,,,
33740,32277,1463,14,,,
27772,23684,4088,17,,,
29446,26042,3404,14,,,
25940,12015,13925,11,,,
23605,14017,9588,18,,,
33497,31089,2408,5,,,
36791,7353,29438,13,,,
34712,16925,17787,2,,,
37569,36098,1471,23,,,
35071,14489,20582,11,,,
30774,24943,5831,17,,,
30147,16855,13292,11,,,
33024,25872,7152,15,,,
27313,10448,16865,7,,,
27451,17164,10287,9,,,
24320,11092,13228,11,,,
33381,30979,2402,16,,,
33275,17495,15780,13,,,
27864,982,26882,12,,,
37744,11404,26340,24,,,
34065,25796,8269,18,,,
26177,2075,24102,22,,,
39665,1077,38588,15,,,
28991,13011,15980,20,,,
17905,12170,5735,14,,,
33433,20029,13404,7,,,
31810,19843,11967,10,,,
27207,20556,6651,25,,,
27061,14454,12607,18,,,
29360,10962,18398,4,,,
31442,3030,28412,15,,,
21877,3884,17993,18,,,
33958,19159,14799,11,,,
31545,15128,16417,10,,,
32349,22272,10077,14,,,
31266,19707,11559,13,,,
27652,21320,6332,6,,,
19424,11308,8116,9,,,
30297,21618,8679,8,,,
31524,18060,13464,15,,,
25374,10488,14886,15,,,
29125,16298,12827,13,,,
34276,29883,4393,17,,,
29670,5749,23921,16,,,
25911,8078,17833,24,,,
33573,19279,14294,21,,,
22233,7888,14345,13,,,
23003,13867,9136,11,,,
31615,11328,20287,7,,,
29474,9025,20449,17,,,
29530,18508,11022,20,,,
32000,18689,13311,4,,,
30164,26600,3564,9,,,
27448,18815,8633,12,,,
29133,23240,5893,18,,,
27405,14876,12529,24,,,
25582,16933,8649,10,,,
33335,28576,4759,5,,,
32888,25211,7677,14,,,
34752,9444,25308,24,,,
31510,21784,9726,7,,,
34066,5537,28529,19,,,
30380,24911,5469,12,,,
36092,17943,18149,19,,,
26225,26021,204,13,,,
31194,4574,26620,7,,,
23701,20485,3216,15,,,
25238,24729,509,11,,,
27683,11357,16326,5,,,
31831,5181,26650,11,,,
29430,20753,8677,17,,,
25781,22909,2872,9,,,
33232,12294,20938,9,,,
23503,1216,22287,8,,,
31309,25955,5354,8,,,
29717,24699,5018,10,,,
29328,16945,12383,15,,,
27096,2196,24900,8,,,
27050,5742,21308,9,,,
33676,20605,13071,7,,,
33734,24445,9289,4,,,
26985,3902,23083,9,,,
27318,25367,1951,20,,,
25858,12394,13464,9,,,
33907,28801,5106,11,,,
27477,17142,10335,9,,,
29357,13979,15378,8,,,
33716,6092,27624,19,,,
29226,22102,7124,15,,,
35869,27573,8296,18,,,
19229,600,18629,16,,,
25828,8939,16889,9,,,
27207,12050,15157,14,,,
31425,25376,6049,17,,,
33501,21291,12210,19,,,
35797,247,35550,14,,,
29451,24615,4836,10,,,
25950,1124,24826,9,,,
27395,4921,22474,7,,,
31510,10078,21432,14,,,
31034,17904,13130,3,,,
23233,14160,9073,21,,,
27320,16079,11241,13,,,
23638,5977,17661,16,,,
37305,1588,35717,9,,,
31698,12482,19216,11,,,
22933,8037,14896,16,,,
29912,27623,2289,7,,,
32174,30099,2075,19,,,
27759,434,27325,12,,,
31725,25391,6334,4,,,
31598,5133,26465,11,,,
29796,7672,22124,8,,,
29817,12276,17541,18,,,
31619,7270,24349,19,,,
35641,3030,32611,27,,,
31886,20363,11523,11,,,
33871,5029,28842,14,,,
33429,30111,3318,14,,,
28238,4355,23883,6,,,
33812,6141,27671,19,,,
32153,17910,14243,12,,,
25803,20483,5320,6,,,
26938,12051,14887,16,,,
37633,36840,793,14,,,
27243,5582,21661,15,,,
35945,7702,28243,14,,,
35777,20506,15271,14,,,
16071,7021,9050,11,,,
29679,7370,22309,11,,,
35507,11142,24365,17,,,
27494,22879,4615,15,,,
29514,3111,26403,14,,,
35921,973,34948,10,,,
30024,8848,21176,10,,,
31187,14982,16205,7,,,
29910,17347,12563,21,,,
31484,809,30675,10,,,
23705,249,23456,9,,,
31219,23710,7509,11,,,
31683,12976,18707,12,,,
25712,11660,14052,23,,,
31537,1132,30405,16,,,
35529,23256,12273,12,,,
33702,9217,24485,18,,,
32808,21683,11125,7,,,
39268,29014,10254,21,,,
33443,21733,11710,14,,,
31659,25669,5990,9,,,
23936,9277,14659,6,,,
28459,7124,21335,21,,,
33343,27442,5901,9,,,
32055,3107,28948,12,,,
31865,18498,13367,13,,,
36111,26273,9838,22,,,
34421,31958,2463,5,,,
39157,37945,1212,4,,,
27555,27425,130,16,,,
31491,12634,18857,6,,,
29184,13952,15232,4,,,
35269,874,34395,4,,,
30176,13100,17076,14,,,
25875,19581,6294,17,,,
31864,4087,27777,16,,,
27657,6118,21539,12,,,
31556,29253,2303,18,,,
31031,11296,19735,24,,,
38175,29397,8778,5,,,
25199,20974,4225,20,,,
31628,11173,20455,12,,,
29498,28847,651,24,,,
32290,24868,7422,17,,,
31235,14702,16533,11,,,
31926,3751,28175,14,,,
19493,1210,18283,6,,,
31363,2174,29189,11,,,
33822,10734,23088,17,,,
27084,11986,15098,7,,,
30067,8618,21449,23,,,
25649,5250,20399,16,,,
25069,1841,23228,11,,,
31061,13387,17674,18,,,
17484,7072,10412,7,,,
33467,876,32591,10,,,
31809,3748,28061,17,,,
25482,19941,5541,8,,,
28960,2424,26536,21,,,
27261,3011,24250,10,,,
30189,27252,2937,23,,,
35423,7439,27984,14,,,
27491,8706,18785,23,,,
33956,10641,23315,17,,,
27729,16278,11451,17,,,
25569,24674,895,24,,,
23852,23466,386,11,,,
33571,25990,7581,5,,,
32336,3133,29203,10,,,
35810,17508,18302,11,,,
33961,14545,19416,21,,,
30265,18724,11541,10,,,
29733,1616,28117,11,,,
25879,10437,15442,12,,,
25092,11723,13369,11,,,
27456,16841,10615,13,,,
36548,28394,8154,10,,,
33275,23776,9499,9,,,
35740,32743,2997,18,,,
21676,15175,6501,7,,,
36255,15948,20307,20,,,
22826,2567,20259,6,,,
23926,15906,8020,16,,,
25500,9038,16462,15,,,
25238,2016,23222,10,,,
27200,7630,19570,14,,,
29177,2080,27097,22,,,
37182,23799,13383,7,,,
31789,25970,5819,31,,,
21811,16958,4853,19,,,
27830,23089,4741,7,,,
33037,27592,5445,12,,,
33275,31446,1829,29,,,
30204,13202,17002,13,,,
27404,22340,5064,12,,,
25493,15751,9742,11,,,
36038,8344,27694,9,,,
35240,35019,221,13,,,
25514,3102,22412,20,,,
35912,15724,20188,10,,,
28268,16053,12215,18,,,
25325,6179,19146,10,,,
35352,32880,2472,9,,,
29612,20735,8877,4,,,
35749,25816,9933,13,,,
29759,2197,27562,19,,,
26008,17745,8263,21,,,
25812,20352,5460,23,,,
27872,26574,1298,13,,,
29742,23549,6193,6,,,
27768,5763,22005,8,,,
37603,12304,25299,17,,,
23779,17439,6340,18,,,
28189,18963,9226,18,,,
33597,7916,25681,8,,,
28053,19484,8569,10,,,
32955,10568,22387,11,,,
22008,14876,7132,16,,,
33415,720,32695,13,,,
25815,6891,18924,17,,,
32980,1553,31427,14,,,
28057,22328,5729,10,,,
31888,28926,2962,17,,,
32174,26179,5995,17,,,
29096,676,28420,21,,,
31773,20819,10954,14,,,
31261,25271,5990,13,,,
37716,36609,1107,7,,,
30766,7882,22884,12,,,
35827,25794,10033,20,,,
32224,7333,24891,18,,,
25960,6033,19927,13,,,
29791,1452,28339,4,,,
31525,24064,7461,20,,,
33084,19713,13371,6,,,
29891,27110,2781,14,,,
31766,16549,15217,5,,,
24954,1918,23036,17,,,
22057,21692,365,12,,,
35940,26272,9668,11,,,
33904,11988,21916,10,,,
33025,25530,7495,19,,,
33401,15033,18368,15,,,
25612,2263,23349,13,,,
25814,21266,4548,14,,,
25455,2556,22899,11,,,
31570,11755,19815,5,,,
25323,5323,20000,4,,,
31549,8508,23041,12,,,
26946,1355,25591,19,,,
24030,22513,1517,7,,,
31429,14608,16821,9,,,
29030,4721,24309,8,,,
36140,29421,6719,13,,,
25765,5708,20057,13,,,
28845,7910,20935,14,,,
30416,8236,22180,12,,,
27759,11404,16355,5,,,
31981,5868,26113,14,,,
25720,15331,10389,5,,,
31692,1153,30539,7,,,
37047,17419,19628,10,,,
34342,32802,1540,11,,,
31613,18743,12870,15,,,
27080,7585,19495,23,,,
27508,4850,22658,11,,,
32017,23838,8179,10,,,
31951,11254,20697,7,,,
25565,997,24568,10,,,
23507,5648,17859,19,,,
31374,31220,154,6,,,
21467,9649,11818,5,,,
21564,16357,5207,14,,,
38584,34923,3661,10,,,
25676,15120,10556,24,,,
29512,5861,23651,34,,,
25398,15486,9912,8,,,
28902,19547,9355,12,,,
37187,26011,11176,16,,,
29878,6060,23818,5,,,
29009,20224,8785,12,,,
25331,11200,14131,6,,,
23987,5016,18971,24,,,
31855,11729,20126,14,,,
30451,19608,10843,14,,,
28150,1395,26755,26,,,
27998,3114,24884,15,,,
29686,9020,20666,17,,,
28186,21805,6381,12,,,
35612,1162,34450,10,,,
28056,16412,11644,22,,,
34858,23832,11026,14,,,
27597,4068,23529,16,,,
33616,13206,20410,10,,,
30888,2576,28312,11,,,
37393,22971,14422,10,,,
39107,38392,715,6,,,
33180,11938,21242,26,,,
27964,6745,21219,15,,,
33255,19642,13613,16,,,
34855,22855,12000,7,,,
13786,2123,11663,20,,,
33769,20486,13283,5,,,
37451,31745,5706,17,,,
29766,21888,7878,17,,,
29095,5789,23306,8,,,
39016,28460,10556,18,,,
23905,16587,7318,12,,,
29527,18099,11428,5,,,
29550,9896,19654,5,,,
27554,11146,16408,25,,,
31500,22993,8507,17,,,
29996,7037,22959,8,,,
24887,12375,12512,10,,,
23229,4766,18463,14,,,
29335,5300,24035,15,,,
27167,24764,2403,17,,,
31294,28877,2417,13,,,
28990,28898,92,28,,,
28337,21330,7007,11,,,
26067,5900,20167,23,,,
24978,5046,19932,18,,,
29748,15067,14681,10,,,
29684,7574,22110,11,,,
36162,17602,18560,11,,,
26357,19351,7006,10,,,
33709,5761,27948,12,,,
32955,26180,6775,17,,,
33038,19975,13063,7,,,
33714,17975,15739,8,,,
25652,20754,4898,9,,,
31515,22668,8847,8,,,
35948,4556,31392,8,,,
25820,9712,16108,10,,,
29660,11636,18024,9,,,
31448,27244,4204,10,,,
33209,27789,5420,12,,,
35263,28688,6575,14,,,
29785,27766,2019,8,,,
27767,5582,22185,13,,,
31037,14944,16093,11,,,
27400,7739,19661,9,,,
29103,18030,11073,14,,,
28987,3045,25942,11,,,
23493,6246,17247,14,,,
33446,15119,18327,15,,,
33534,13738,19796,5,,,
32059,6971,25088,14,,,
31472,22272,9200,11,,,
29570,23481,6089,19,,,
23802,21815,1987,22,,,
31521,7843,23678,10,,,
29618,1459,28159,13,,,
30219,18818,11401,14,,,
27594,27457,137,16,,,
37593,15816,21777,17,,,
27918,13956,13962,24,,,
32358,29094,3264,9,,,
29551,17035,12516,19,,,
25379,24497,882,15,,,
30105,7874,22231,10,,,
31624,29431,2193,6,,,
33043,23316,9727,25,,,
32709,13444,19265,18,,,
31436,7559,23877,11,,,
32813,29727,3086,11,,,
34137,31352,2785,22,,,
28033,11207,16826,5,,,
29702,16584,13118,11,,,
29914,8377,21537,12,,,
29525,12643,16882,24,,,
27631,16890,10741,9,,,
34122,12687,21435,7,,,
27174,12108,15066,18,,,
28014,22469,5545,8,,,
29499,19988,9511,10,,,
33756,26609,7147,9,,,
27756,23633,4123,23,,,
29424,23476,5948,28,,,
27790,22701,5089,15,,,
27663,5506,22157,15,,,
31579,15252,16327,5,,,
27619,8960,18659,17,,,
35566,27997,7569,13,,,
23282,6196,17086,11,,,
29570,17113,12457,24,,,
33016,6787,26229,16,,,
29674,6986,22688,9,,,
32127,4088,28039,19,,,
21491,12129,9362,28,,,
32009,18903,13106,13,,,
35739,13187,22552,10,,,
27191,46,27145,6,,,
21674,19856,1818,21,,,
29921,2321,27600,6,,,
30117,14792,15325,22,,,
26692,15502,11190,7,,,
25488,23309,2179,14,,,
33323,7391,25932,9,,,
29085,28322,763,17,,,
31801,9594,22207,15,,,
28159,24693,3466,22,,,
35644,21565,14079,9,,,
25602,15506,10096,14,,,
36146,30969,5177,13,,,
33363,3174,30189,24,,,
29072,20371,8701,12,,,
21687,15207,6480,10,,,
33618,11536,22082,13,,,
29788,26536,3252,12,,,
29761,9231,20530,16,,,
35932,1889,34043,22,,,
30043,10499,19544,18,,,
23762,6354,17408,20,,,
32125,13846,18279,27,,,
25082,18932,6150,12,,,
32312,16476,15836,11,,,
29460,15322,14138,13,,,
31610,14618,16992,17,,,
36004,16687,19317,13,,,
31322,27811,3511,12,,,
32983,5715,27268,14,,,
28064,12817,15247,10,,,
24084,4087,19997,13,,,
29599,24078,5521,4,,,
28867,851,28016,30,,,
29258,20367,8891,16,,,
33171,18295,14876,8,,,
35721,14843,20878,11,,,
25640,21884,3756,7,,,
35947,35324,623,20,,,
29898,4090,25808,13,,,
28211,27600,611,9,,,
31336,7640,23696,20,,,
30146,18746,11400,16,,,
38862,3930,34932,14,,,
31087,22403,8684,16,,,
27502,67,27435,11,,,
29115,13503,15612,15,,,
33288,7589,25699,16,,,
29961,20714,9247,14,,,
23182,3179,20003,13,,,
32119,30890,1229,15,,,
26962,20425,6537,13,,,
34110,22772,11338,12,,,
30386,10139,20247,10,,,
26961,21130,5831,8,,,
29427,6644,22783,12,,,
28086,24340,3746,10,,,
31407,3913,27494,20,,,
37725,16823,20902,9,,,
30037,18274,11763,10,,,
35336,24496,10840,23,,,
37632,4968,32664,25,,,
27040,24917,2123,21,,,
34856,16130,18726,19,,,
33424,17271,16153,12,,,
33738,4819,28919,11,,,
33929,11460,22469,11,,,
35345,27550,7795,6,,,
26914,5892,21022,18,,,
24676,6608,18068,16,,,
30489,26705,3784,8,,,
27602,26908,694,15,,,
28937,27142,1795,18,,,
32057,21501,10556,17,,,
39104,25093,14011,28,,,
31869,28962,2907,14,,,
25830,6264,19566,17,,,
30158,8963,21195,15,,,
31547,14339,17208,23,,,
29174,21822,7352,17,,,
29353,23303,6050,8,,,
27370,14885,12485,11,,,
31733,8455,23278,10,,,
23634,13433,10201,11,,,
28199,3287,24912,28,,,
33279,22340,10939,10,,,
31809,14916,16893,20,,,
30352,19965,10387,15,,,
23971,11214,12757,17,,,
29607,7920,21687,16,,,
33728,27489,6239,12,,,
30597,26468,4129,19,,,
28919,12526,16393,6,,,
29511,16448,13063,13,,,
27589,18427,9162,16,,,
31210,3970,27240,18,,,
27196,2902,24294,15,,,
27716,3984,23732,21,,,
31033,29381,1652,25,,,
34138,14904,19234,10,,,
33191,2861,30330,11,,,
25531,19937,5594,17,,,
32742,19961,12781,18,,,
27706,7126,20580,11,,,
32465,27982,4483,10,,,
23038,1424,21614,8,,,
29146,23404,5742,20,,,
34192,32537,1655,10,,,
29548,17878,11670,15,,,
33955,10417,23538,10,,,
31135,29184,1951,14,,,
25820,7751,18069,9,,,
31606,7819,23787,11,,,
31672,11919,19753,12,,,
33088,13792,19296,14,,,
27220,12612,14608,17,,,
26044,24219,1825,17,,,
31465,14562,16903,19,,,
27219,23975,3244,4,,,
27434,26264,1170,16,,,
27721,4195,23526,11,,,
23142,22505,637,16,,,
31332,20083,11249,8,,,
33055,20437,12618,29,,,
29695,20737,8958,14,,,
29354,16577,12777,13,,,
29266,22508,6758,16,,,
34491,27277,7214,11,,,
23636,19710,3926,14,,,
31608,21380,10228,8,,,
31503,25579,5924,13,,,
33975,21784,12191,15,,,
29539,16888,12651,5,,,
30047,17198,12849,10,,,
27224,9045,18179,16,,,
34936,34835,101,9,,,
26094,16724,9370,19,,,
29110,24416,4694,9,,,
25630,9103,16527,13,,,
33057,17256,15801,4,,,
24669,6717,17952,14,,,
25854,9399,16455,16,,,
32364,26357,6007,6,,,
29209,10156,19053,15,,,
25655,14510,11145,16,,,
26418,1323,25095,9,,,
32011,6613,25398,12,,,
35715,19973,15742,11,,,
25466,19669,5797,16,,,
33043,32149,894,11,,,
35022,6470,28552,9,,,
36107,30190,5917,15,,,
27459,23566,3893,26,,,
33327,29140,4187,15,,,
29154,7796,21358,12,,,
37286,4535,32751,7,,,
23659,20446,3213,22,,,
25872,12935,12937,9,,,
29370,3438,25932,16,,,
15645,15325,320,10,,,
32870,20902,11968,15,,,
29080,10152,18928,12,,,
25093,2760,22333,20,,,
35794,19052,16742,17,,,
19737,16650,3087,24,,,
39050,19556,19494,10,,,
28240,20349,7891,18,,,
31545,11910,19635,8,,,
31532,4290,27242,22,,,
27356,7458,19898,10,,,
29965,4081,25884,14,,,
29938,13418,16520,19,,,
30534,11837,18697,9,,,
25855,24439,1416,12,,,
26177,18662,7515,18,,,
23551,8499,15052,18,,,
27771,2820,24951,9,,,
27732,20655,7077,10,,,
29586,11878,17708,5,,,
31890,16987,14903,10,,,
27640,335,27305,14,,,
28417,427,27990,14,,,
25918,1226,24692,15,,,
32098,21004,11094,10,,,
29917,19019,10898,32,,,
25472,4519,20953,13,,,
35883,261,35622,7,,,
30000,4960,25040,6,,,
27864,2749,25115,15,,,
26376,4068,22308,13,,,
21608,15709,5899,12,,,
33452,17141,16311,10,,,
27751,11782,15969,17,,,
25574,8148,17426,6,,,
31271,30030,1241,11,,,
31499,18482,13017,6,,,
29781,29053,728,13,,,
27463,15218,12245,20,,,
25826,4159,21667,13,,,
29896,8361,21535,13,,,
27625,9220,18405,8,,,
29546,7933,21613,13,,,
23760,6735,17025,6,,,
29402,25897,3505,20,,,
36196,13116,23080,5,,,
33779,24370,9409,12,,,
33494,31022,2472,13,,,
33175,3107,30068,9,,,
25825,14211,11614,6,,,
32324,25771,6553,7,,,
33674,15284,18390,14,,,
23814,2801,21013,9,,,
21013,10792,10221,15,,,
25240,19380,5860,17,,,
23773,7072,16701,6,,,
17587,7200,10387,10,,,
27243,19174,8069,5,,,
29813,13228,16585,18,,,
25865,20856,5009,14,,,
27132,254,26878,17,,,
31335,7076,24259,20,,,
33511,25100,8411,29,,,
23439,11160,12279,21,,,
20746,5972,14774,7,,,
29659,15627,14032,27,,,
23675,7069,16606,17,,,
27104,18704,8400,27,,,
33690,27454,6236,6,,,
25212,13957,11255,13,,,
27687,22559,5128,13,,,
29652,29120,532,6,,,
35682,8225,27457,9,,,
29198,24099,5099,6,,,
28048,9138,18910,9,,,
21533,12038,9495,13,,,
32012,1105,30907,18,,,
33869,24743,9126,12,,,
27581,15516,12065,19,,,
25824,2267,23557,13,,,
31162,15781,15381,15,,,
35285,14057,21228,8,,,
31044,13444,17600,7,,,
29874,4685,25189,16,,,
28074,8397,19677,16,,,
26280,8548,17732,13,,,
25422,16010,9412,9,,,
27739,1550,26189,6,,,
33535,2264,31271,7,,,
34099,4123,29976,20,,,
23490,8593,14897,11,,,
31501,2482,29019,13,,,
25121,21122,3999,12,,,
35263,18503,16760,14,,,
28151,1937,26214,9,,,
21314,6039,15275,11,,,
27225,26264,961,15,,,
23970,9760,14210,10,,,
34167,9781,24386,14,,,
39145,33861,5284,6,,,
31133,3912,27221,14,,,
29571,11668,17903,17,,,
33578,32997,581,27,,,
36029,20971,15058,18,,,
28685,28325,360,18,,,
27315,14727,12588,17,,,
21793,6252,15541,14,,,
25353,14124,11229,15,,,
23736,17492,6244,21,,,
29963,28266,1697,10,,,
26868,16912,9956,16,,,
25145,17026,8119,14,,,
32346,9013,23333,11,,,
27173,10523,16650,3,,,
31758,26737,5021,10,,,
29249,24521,4728,6,,,
27677,26972,705,18,,,
32962,29897,3065,22,,,
25572,15646,9926,5,,,
28100,11527,16573,10,,,
25830,22238,3592,16,,,
32800,20528,12272,16,,,
34861,10459,24402,21,,,
34262,29311,4951,16,,,
25551,8507,17044,10,,,
28968,8150,20818,11,,,
30220,25527,4693,14,,,
24696,7060,17636,21,,,
29636,24960,4676,22,,,
37897,10866,27031,12,,,
27183,20151,7032,13,,,
29162,22103,7059,16,,,
31379,7322,24057,14,,,
25458,23326,2132,16,,,
29024,17168,11856,15,,,
31487,13632,17855,19,,,
27308,25400,1908,8,,,
23643,22139,1504,11,,,
33455,7463,25992,5,,,
25137,8016,17121,22,,,
28014,9873,18141,11,,,
23558,16146,7412,10,,,
24176,6100,18076,13,,,
28210,4091,24119,4,,,
28147,16391,11756,18,,,
34737,4992,29745,14,,,
35811,30081,5730,10,,,
28085,23726,4359,15,,,
29890,29699,191,16,,,
31916,25206,6710,16,,,
31161,11434,19727,8,,,
33055,20620,12435,8,,,
24080,633,23447,14,,,
25513,14126,11387,18,,,
27831,25622,2209,5,,,
28925,27061,1864,13,,,
23101,23031,70,7,,,
34227,19862,14365,10,,,
27378,26465,913,15,,,
29488,26838,2650,14,,,
35890,34083,1807,23,,,
33247,30912,2335,6,,,
18016,14272,3744,11,,,
33268,31006,2262,17,,,
33617,2775,30842,10,,,
31386,27361,4025,12,,,
27634,588,27046,19,,,
32063,1343,30720,24,,,
34054,22357,11697,12,,,
25404,21932,3472,11,,,
27810,3071,24739,8,,,
25502,17680,7822,11,,,
31626,2456,29170,8,,,
21776,12218,9558,26,,,
27285,11355,15930,8,,,
30834,4827,26007,13,,,
31742,29195,2547,17,,,
23918,16763,7155,10,,,
27644,20172,7472,18,,,
33770,33086,684,10,,,
32019,20717,11302,14,,,
35072,22791,12281,12,,,
27668,13491,14177,6,,,
29147,27587,1560,15,,,
31486,24257,7229,25,,,
35765,2882,32883,20,,,
27478,24360,3118,14,,,
33082,12948,20134,10,,,
31865,20534,11331,12,,,
35682,18542,17140,4,,,
23501,11575,11926,17,,,
33635,21892,11743,9,,,
22196,11483,10713,19,,,
31700,17890,13810,15,,,
27967,9934,18033,15,,,
28767,6260,22507,13,,,
30239,17375,12864,13,,,
37764,5824,31940,10,,,
32018,18373,13645,10,,,
25265,6734,18531,14,,,
23277,6296,16981,10,,,
25812,15175,10637,17,,,
27832,22228,5604,18,,,
31922,22491,9431,12,,,
25726,23057,2669,15,,,
27970,24575,3395,9,,,
29635,13218,16417,6,,,
29906,102,29804,24,,,
27880,14242,13638,14,,,
31936,7739,24197,17,,,
34282,25874,8408,12,,,
19824,18566,1258,14,,,
30920,23006,7914,15,,,
32163,8263,23900,11,,,
28903,15222,13681,19,,,
29871,20548,9323,19,,,
29133,20009,9124,21,,,
29610,1398,28212,9,,,
27534,15923,11611,12,,,
35705,34254,1451,17,,,
32754,6447,26307,13,,,
23644,16894,6750,14,,,
27137,8298,18839,17,,,
33092,19406,13686,13,,,
32854,2586,30268,18,,,
29507,28861,646,12,,,
28289,14244,14045,16,,,
33807,26728,7079,21,,,
23541,17886,5655,6,,,
27441,11999,15442,9,,,
29840,20820,9020,5,,,
29715,6152,23563,14,,,
29122,12174,16948,13,,,
27547,22676,4871,6,,,
30037,15349,14688,14,,,
32020,17728,14292,17,,,
31321,22074,9247,8,,,
31803,24389,7414,9,,,
27476,4673,22803,16,,,
35662,29042,6620,18,,,
29165,7473,21692,7,,,
31449,4969,26480,15,,,
31841,27525,4316,9,,,
29673,19736,9937,16,,,
31949,9689,22260,23,,,
33799,23393,10406,18,,,
27394,20178,7216,12,,,
32794,15138,17656,12,,,
25680,11294,14386,14,,,
18128,17450,678,9,,,
38609,37455,1154,4,,,
27534,11804,15730,10,,,
25954,2754,23200,9,,,
29822,15624,14198,5,,,
29026,19631,9395,14,,,
23647,21098,2549,8,,,
25636,17281,8355,12,,,
33217,25132,8085,12,,,
27665,9888,17777,14,,,
25333,9673,15660,14,,,
24084,19898,4186,13,,,
35899,26091,9808,16,,,
33120,15526,17594,12,,,
30805,19155,11650,19,,,
27379,18825,8554,14,,,
35484,16171,19313,11,,,
26163,855,25308,14,,,
36558,12455,24103,33,,,
25738,21000,4738,11,,,
29382,17009,12373,14,,,
29041,27921,1120,15,,,
35273,13583,21690,16,,,
30273,5596,24677,15,,,
21341,20571,770,8,,,
31727,402,31325,13,,,
31478,4850,26628,14,,,
29680,17216,12464,11,,,
21712,14426,7286,19,,,
33161,18989,14172,19,,,
31576,25487,6089,10,,,
29712,23254,6458,19,,,
23386,21427,1959,10,,,
33865,9389,24476,25,,,
21989,16705,5284,7,,,
28577,24935,3642,12,,,
35841,8062,27779,12,,,
27405,23456,3949,10,,,
30151,26672,3479,12,,,
29356,5919,23437,10,,,
34123,9920,24203,8,,,
33918,23459,10459,19,,,
32525,13248,19277,12,,,
29189,24657,4532,14,,,
30954,19747,11207,15,,,
29086,7646,21440,15,,,
23703,21791,1912,11,,,
28038,5493,22545,14,,,
28075,2308,25767,9,,,
35963,30687,5276,15,,,
31676,4875,26801,12,,,
33822,16572,17250,21,,,
30160,9664,20496,19,,,
33710,6801,26909,5,,,
33214,13548,19666,15,,,
35172,23982,11190,17,,,
27204,9581,17623,9,,,
25108,1877,23231,9,,,
35872,9977,25895,12,,,
24246,18420,5826,15,,,
22967,18401,4566,11,,,
31954,26946,5008,9,,,
31832,29981,1851,16,,,
36139,2183,33956,10,,,
27718,2448,25270,11,,,
29303,9902,19401,5,,,
27597,14186,13411,17,,,
31082,9129,21953,6,,,
31363,13244,18119,18,,,
30009,347,29662,6,,,
34494,1465,33029,12,,,
21676,4679,16997,13,,,
29730,1924,27806,4,,,
20060,16695,3365,13,,,
30396,6375,24021,11,,,
25329,2159,23170,14,,,
27759,16094,11665,7,,,
21873,3622,18251,13,,,
26150,24459,1691,21,,,
33710,32359,1351,11,,,
26089,24727,1362,18,,,
31671,13308,18363,10,,,
31075,27518,3557,23,,,
30128,30067,61,19,,,
34111,12290,21821,23,,,
37244,32989,4255,21,,,
27634,17029,10605,15,,,
34402,17326,17076,10,,,
22117,2623,19494,11,,,
25672,21656,4016,16,,,
15846,2726,13120,12,,,
26068,22048,4020,17,,,
19598,113,19485,20,,,
36106,32140,3966,25,,,
21580,6808,14772,15,,,
39180,5869,33311,10,,,
25530,1491,24039,14,,,
32095,8036,24059,17,,,
27548,1311,26237,10,,,
35505,2221,33284,9,,,
25836,22339,3497,7,,,
21342,14664,6678,4,,,
30543,22793,7750,9,,,
31987,1355,30632,10,,,
32355,24742,7613,17,,,
25576,8281,17295,9,,,
25659,15160,10499,14,,,
35417,30030,5387,11,,,
31074,10297,20777,7,,,
33215,14982,18233,20,,,
29500,18588,10912,13,,,
31040,4555,26485,22,,,
33007,32147,860,19,,,
31602,15160,16442,18,,,
36957,30736,6221,9,,,
21906,3905,18001,17,,,
24050,9610,14440,9,,,
35504,8585,26919,13,,,
31273,240,31033,11,,,
27800,2767,25033,14,,,
30291,15083,15208,10,,,
34220,16524,17696,7,,,
29997,4529,25468,13,,,
29575,13091,16484,13,,,
29819,26389,3430,15,,,
29783,26245,3538,9,,,
29681,17915,11766,21,,,
27275,9499,17776,14,,,
31759,17651,14108,15,,,
31546,27195,4351,7,,,
23460,8133,15327,12,,,
20334,12715,7619,7,,,
29782,1514,28268,8,,,
27483,9417,18066,22,,,
31815,10636,21179,8,,,
33988,434,33554,9,,,
33208,20630,12578,10,,,
38861,16791,22070,12,,,
25519,13884,11635,19,,,
37121,88,37033,19,,,
34053,16135,17918,8,,,
31347,8858,22489,18,,,
34906,17155,17751,18,,,
25792,14369,11423,9,,,
34031,15643,18388,14,,,
29914,28996,918,8,,,
32395,30528,1867,22,,,
31954,10268,21686,21,,,
35784,34570,1214,18,,,
21338,20995,343,8,,,
27948,3012,24936,7,,,
25877,1985,23892,14,,,
25754,13192,12562,11,,,
34149,28049,6100,14,,,
31984,29011,2973,11,,,
27081,5356,21725,12,,,
21327,18841,2486,6,,,
27712,26240,1472,8,,,
31412,7459,23953,12,,,
30251,25838,4413,24,,,
33527,31082,2445,10,,,
25685,16256,9429,6,,,
22030,5937,16093,10,,,
23745,557,23188,16,,,
23301,6242,17059,11,,,
29694,28250,1444,12,,,
35886,35701,185,12,,,
32092,4492,27600,28,,,
28899,8256,20643,15,,,
22964,7281,15683,26,,,
29687,9814,19873,11,,,
24092,9464,14628,22,,,
30004,23143,6861,21,,,
36171,20602,15569,18,,,
27872,15116,12756,14,,,
29378,3566,25812,12,,,
21483,5304,16179,23,,,
31613,14238,17375,10,,,
27647,20724,6923,13,,,
33197,14507,18690,15,,,
31409,26410,4999,10,,,
28273,4618,23655,17,,,
30007,5615,24392,19,,,
26320,6221,20099,8,,,
27625,22141,5484,6,,,
33596,10972,22624,17,,,
31756,24671,7085,10,,,
29259,21623,7636,11,,,
31682,2973,28709,6,,,
28047,18169,9878,12,,,
33424,21710,11714,15,,,
31837,6931,24906,17,,,
27522,2979,24543,16,,,
27050,20665,6385,20,,,
31624,30044,1580,13,,,
27655,24826,2829,10,,,
25400,24180,1220,4,,,
31684,17082,14602,11,,,
24355,8042,16313,27,,,
31672,15612,16060,22,,,
23551,21585,1966,11,,,
30938,19189,11749,21,,,
29602,10794,18808,6,,,
24235,17213,7022,26,,,
31375,18881,12494,22,,,
32792,21033,11759,23,,,
29537,7244,22293,9,,,
27665,16910,10755,15,,,
35576,12919,22657,13,,,
35593,29532,6061,8,,,
29614,23590,6024,19,,,
35797,30338,5459,10,,,
27928,21958,5970,9,,,
29480,6206,23274,24,,,
19159,15886,3273,18,,,
29262,6602,22660,14,,,
23789,6595,17194,9,,,
23481,19964,3517,12,,,
27975,16870,11105,15,,,
32332,7292,25040,18,,,
27271,7652,19619,14,,,
33193,11829,21364,28,,,
21577,20907,670,17,,,
29205,23128,6077,9,,,
36057,6045,30012,13,,,
27525,13039,14486,12,,,
19632,12137,7495,13,,,
29491,5933,23558,15,,,
27652,1791,25861,17,,,
25677,15333,10344,22,,,
33814,20303,13511,11,,,
33445,15104,18341,16,,,
25716,18102,7614,22,,,
27405,17984,9421,16,,,
29341,17503,11838,6,,,
21850,20194,1656,14,,,
33813,1040,32773,28,,,
21750,2682,19068,15,,,
30988,8966,22022,13,,,
33373,17161,16212,17,,,
25731,8652,17079,26,,,
29730,15239,14491,10,,,
29875,26778,3097,12,,,
30660,24174,6486,14,,,
29189,24996,4193,18,,,
29084,5918,23166,21,,,
21713,7030,14683,12,,,
28051,22183,5868,15,,,
27321,11818,15503,12,,,
28052,26226,1826,13,,,
29492,8064,21428,10,,,
30775,6067,24708,11,,,
34665,24253,10412,6,,,
33368,19991,13377,15,,,
25585,24489,1096,15,,,
29910,12615,17295,12,,,
27543,13039,14504,17,,,
27330,7359,19971,12,,,
33473,1917,31556,19,,,
25934,19495,6439,20,,,
24085,8032,16053,13,,,
32917,22718,10199,10,,,
27301,1521,25780,23,,,
34073,19748,14325,12,,,
21785,9155,12630,17,,,
25871,23159,2712,15,,,
33850,3026,30824,7,,,
27236,14791,12445,7,,,
31871,10974,20897,6,,,
23270,12766,10504,18,,,
31515,484,31031,11,,,
29153,21709,7444,15,,,
23497,10232,13265,15,,,
26233,3355,22878,12,,,
29667,25496,4171,7,,,
29609,10628,18981,9,,,
25687,2314,23373,17,,,
25691,15021,10670,16,,,
25536,15317,10219,10,,,
28773,1926,26847,12,,,
27260,22189,5071,19,,,
31006,25549,5457,6,,,
33477,21192,12285,18,,,
33914,31125,2789,12,,,
29349,1328,28021,11,,,
27705,5027,22678,15,,,
35582,22165,13417,14,,,
29324,5354,23970,21,,,
35507,10205,25302,28,,,
25463,14701,10762,10,,,
33562,5218,28344,23,,,
21328,138,21190,21,,,
31373,3576,27797,11,,,
29720,13399,16321,19,,,
26876,22318,4558,12,,,
26110,6435,19675,12,,,
27417,13690,13727,11,,,
31484,30898,586,16,,,
25861,25247,614,10,,,
25434,807,24627,15,,,
33188,5625,27563,9,,,
33772,10279,23493,23,,,
23489,10337,13152,10,,,
31150,7191,23959,11,,,
21915,14458,7457,21,,,
29572,15232,14340,15,,,
33672,33201,471,23,,,
33846,21533,12313,18,,,
27639,23910,3729,8,,,
27949,1597,26352,21,,,
31249,26239,5010,16,,,
27758,13751,14007,10,,,
35200,1855,33345,13,,,
29928,17747,12181,14,,,
26008,7871,18137,15,,,
32444,28462,3982,16,,,
35436,4790,30646,13,,,
35638,12322,23316,16,,,
35084,29609,5475,9,,,
29412,7059,22353,28,,,
19405,8331,11074,7,,,
31245,27403,3842,16,,,
22938,17216,5722,14,,,
27290,10942,16348,12,,,
24361,13664,10697,22,,,
31501,16852,14649,8,,,
32144,8922,23222,13,,,
34796,5127,29669,16,,,
33968,17575,16393,12,,,
35748,21930,13818,9,,,
27002,16371,10631,9,,,
37150,22824,14326,22,,,
31104,11818,19286,9,,,
29789,26712,3077,16,,,
34675,14963,19712,27,,,
34270,31308,2962,8,,,
33620,18141,15479,29,,,
32080,7632,24448,8,,,
31025,17946,13079,15,,,
30195,23010,7185,12,,,
27850,19324,8526,17,,,
31413,18836,12577,10,,,
39439,36086,3353,12,,,
29639,7999,21640,15,,,
29248,7040,22208,12,,,
27925,10440,17485,7,,,
28089,15507,12582,12,,,
31919,27160,4759,13,,,
27597,2326,25271,9,,,
35185,12058,23127,10,,,
33766,21272,12494,12,,,
33136,429,32707,9,,,
27805,25977,1828,5,,,
33639,16863,16776,18,,,
30564,25243,5321,6,,,
26912,520,26392,4,,,
32146,6767,25379,13,,,
35048,25949,9099,12,,,
26257,1175,25082,17,,,
31877,27285,4592,20,,,
29589,18621,10968,24,,,
22786,9001,13785,14,,,
25860,18262,7598,14,,,
33929,3033,30896,9,,,
26053,6399,19654,18,,,
29536,24348,5188,24,,,
37719,37248,471,7,,,
31445,1536,29909,20,,,
35864,12120,23744,15,,,
32037,21179,10858,5,,,
31707,15055,16652,14,,,
31429,25234,6195,15,,,
25578,3677,21901,20,,,
29228,10585,18643,11,,,
33063,13598,19465,3,,,
26119,14417,11702,14,,,
27237,12705,14532,15,,,
31195,15710,15485,15,,,
35680,2765,32915,13,,,
33903,29026,4877,15,,,
28371,12312,16059,20,,,
32619,18288,14331,16,,,
35390,25288,10102,8,,,
36785,34761,2024,18,,,
27069,23132,3937,21,,,
35810,1163,34647,19,,,
25517,19821,5696,8,,,
21447,2654,18793,17,,,
30100,14328,15772,7,,,
35845,9808,26037,14,,,
19962,10944,9018,14,,,
33803,32121,1682,12,,,
32891,27730,5161,14,,,
21892,14810,7082,20,,,
33532,7301,26231,13,,,
33786,31075,2711,12,,,
30009,16057,13952,12,,,
31814,6590,25224,11,,,
29495,2853,26642,12,,,
35241,19412,15829,21,,,
30065,9512,20553,14,,,
27794,360,27434,8,,,
26320,2923,23397,17,,,
24534,14038,10496,24,,,
29980,1439,28541,11,,,
25970,5395,20575,16,,,
25265,3078,22187,12,,,
31049,3305,27744,15,,,
29457,26773,2684,17,,,
29750,20634,9116,10,,,
36275,18180,18095,17,,,
29867,22308,7559,13,,,
33227,1864,31363,19,,,
26752,10650,16102,13,,,
35478,3293,32185,12,,,
31190,29395,1795,17,,,
33505,31515,1990,12,,,
31333,8195,23138,9,,,
31495,4966,26529,21,,,
27897,6399,21498,7,,,
21835,6192,15643,8,,,
35346,28616,6730,16,,,
35005,33524,1481,11,,,
34135,22238,11897,18,,,
29247,23493,5754,15,,,
25677,19419,6258,4,,,
21353,7013,14340,11,,,
33316,7882,25434,15,,,
29977,17770,12207,14,,,
33517,27835,5682,10,,,
32968,20618,12350,16,,,
33591,1538,32053,14,,,
33212,11021,22191,11,,,
24408,11948,12460,5,,,
29660,24230,5430,4,,,
35969,25881,10088,10,,,
29043,26697,2346,12,,,
31670,24645,7025,9,,,
23965,16639,7326,5,,,
28186,2072,26114,27,,,
27453,9902,17551,4,,,
29231,21429,7802,20,,,
27471,5937,21534,14,,,
29031,20291,8740,17,,,
29091,6076,23015,12,,,
31584,21402,10182,10,,,
37972,37220,752,8,,,
31191,16802,14389,28,,,
31475,3089,28386,17,,,
28001,5540,22461,10,,,
25300,308,24992,14,,,
31612,3728,27884,11,,,
25772,14408,11364,12,,,
23506,12786,10720,14,,,
23631,10846,12785,11,,,
22413,2501,19912,22,,,
33402,27208,6194,13,,,
31785,25291,6494,11,,,
23579,14105,9474,10,,,
30092,24260,5832,13,,,
31123,21947,9176,12,,,
23836,22856,980,15,,,
28854,27781,1073,13,,,
31731,4577,27154,14,,,
28436,25110,3326,10,,,
29251,15948,13303,16,,,
38229,15652,22577,13,,,
30100,28306,1794,14,,,
30969,8008,22961,13,,,
28917,19329,9588,12,,,
24113,11472,12641,4,,,
31798,23014,8784,14,,,
34014,29565,4449,18,,,
29405,38,29367,13,,,
24694,6387,18307,21,,,
29354,28675,679,15,,,
30267,13972,16295,7,,,
31473,2647,28826,17,,,
36904,20344,16560,18,,,
26077,3701,22376,23,,,
33345,27568,5777,18,,,
29836,23954,5882,29,,,
29345,14515,14830,7,,,
32003,8106,23897,14,,,
27535,862,26673,6,,,
30810,11613,19197,9,,,
28380,15243,13137,9,,,
31720,17923,13797,5,,,
22769,8441,14328,10,,,
25678,22534,3144,22,,,
17881,11038,6843,13,,,
28272,2891,25381,10,,,
27218,3693,23525,10,,,
21952,9330,12622,10,,,
36266,29155,7111,11,,,
31160,7758,23402,10,,,
39870,24090,15780,16,,,
27836,17377,10459,16,,,
25518,18947,6571,8,,,
34780,6123,28657,9,,,
25480,7976,17504,4,,,
28378,19421,8957,22,,,
27207,25024,2183,17,,,
25234,17430,7804,21,,,
29934,22278,7656,26,,,
33915,202,33713,4,,,
33380,3346,30034,13,,,
27350,25275,2075,9,,,
27377,4065,23312,15,,,
27260,16892,10368,8,,,
21830,12809,9021,15,,,
30042,8470,21572,10,,,
31729,26583,5146,5,,,
31572,20276,11296,15,,,
21669,21015,654,19,,,
29257,21666,7591,17,,,
25341,13906,11435,9,,,
31914,26115,5799,10,,,
31489,16153,15336,11,,,
29630,13347,16283,8,,,
31364,22892,8472,16,,,
29462,7713,21749,9,,,
23871,7511,16360,6,,,
31825,27792,4033,12,,,
25449,4800,20649,19,,,
31594,1363,30231,14,,,
31680,12877,18803,16,,,
28942,26074,2868,13,,,
25968,318,25650,10,,,
27865,9933,17932,14,,,
25555,12742,12813,8,,,
24252,19971,4281,6,,,
27491,15536,11955,10,,,
27133,23541,3592,14,,,
38020,29181,8839,15,,,
32504,6030,26474,9,,,
32175,12404,19771,5,,,
35248,2515,32733,20,,,
24034,4237,19797,13,,,
29047,7391,21656,7,,,
32986,20450,12536,15,,,
21945,15798,6147,21,,,
35672,13871,21801,23,,,
23166,11352,11814,11,,,
31287,7547,23740,16,,,
26835,5193,21642,18,,,
27609,20429,7180,9,,,
31510,4467,27043,12,,,
29578,18544,11034,22,,,
37755,26869,10886,19,,,
31509,9574,21935,6,,,
27550,21012,6538,21,,,
38021,27298,10723,13,,,
31944,28506,3438,14,,,
23420,7500,15920,19,,,
32316,31515,801,8,,,
34243,23260,10983,9,,,
25299,5543,19756,22,,,
29725,27315,2410,12,,,
34120,21520,12600,13,,,
29856,4700,25156,20,,,
33884,15609,18275,14,,,
29445,21085,8360,10,,,
23613,7345,16268,13,,,
37685,4959,32726,16,,,
31726,28310,3416,14,,,
25561,7862,17699,12,,,
27163,21518,5645,22,,,
34341,20754,13587,8,,,
34242,17977,16265,16,,,
32324,7150,25174,14,,,
29028,27152,1876,21,,,
33995,23428,10567,12,,,
38079,30373,7706,8,,,
35302,31407,3895,12,,,
32022,5029,26993,18,,,
35713,11130,24583,16,,,
27779,8364,19415,17,,,
27820,18083,9737,5,,,
37828,32840,4988,13,,,
29402,4641,24761,9,,,
33852,14391,19461,10,,,
33696,33300,396,15,,,
32051,15088,16963,12,,,
35728,3575,32153,20,,,
36063,7558,28505,5,,,
31061,4796,26265,15,,,
24410,19820,4590,7,,,
32750,22562,10188,13,,,
31926,2373,29553,18,,,
31570,28933,2637,19,,,
27845,1828,26017,12,,,
25520,7604,17916,9,,,
25359,5165,20194,7,,,
27356,12048,15308,12,,,
25779,12631,13148,20,,,
27415,8765,18650,15,,,
23518,21587,1931,12,,,
34082,32388,1694,9,,,
36280,3505,32775,13,,,
25906,15042,10864,14,,,
30539,23188,7351,11,,,
27613,15447,12166,14,,,
25281,11380,13901,22,,,
30899,726,30173,16,,,
30009,4767,25242,17,,,
35001,29864,5137,14,,,
33195,23731,9464,5,,,
29778,25461,4317,14,,,
23373,22875,498,12,,,
35738,32723,3015,19,,,
23499,18993,4506,15,,,
29722,8036,21686,11,,,
31797,7537,24260,18,,,
27075,1251,25824,8,,,
27841,26474,1367,15,,,
27213,25012,2201,21,,,
25589,7269,18320,14,,,
23402,7995,15407,20,,,
26143,1983,24160,20,,,
33042,10841,22201,12,,,
29757,25398,4359,20,,,
21620,11732,9888,20,,,
36332,31146,5186,11,,,
32804,5438,27366,11,,,
37341,35050,2291,10,,,
38077,32001,6076,22,,,
34035,13377,20658,26,,,
30866,10241,20625,14,,,
23585,5309,18276,11,,,
29588,22571,7017,8,,,
31569,18286,13283,19,,,
27399,13419,13980,17,,,
29777,20287,9490,15,,,
34063,19746,14317,10,,,
27389,19792,7597,17,,,
32651,11379,21272,5,,,
34245,7366,26879,11,,,
27209,13928,13281,11,,,
25286,21122,4164,13,,,
34312,15603,18709,18,,,
23734,8079,15655,14,,,
37774,8718,29056,14,,,
33358,27468,5890,18,,,
29661,19896,9765,14,,,
27886,1258,26628,12,,,
26892,17772,9120,22,,,
29381,8886,20495,18,,,
25382,17921,7461,9,,,
35237,34065,1172,21,,,
29881,6954,22927,8,,,
27112,22453,4659,21,,,
25655,8832,16823,15,,,
26948,2606,24342,18,,,
29446,5525,23921,12,,,
27807,27395,412,8,,,
27439,18662,8777,9,,,
32954,25481,7473,10,,,
29461,17693,11768,10,,,
35040,5597,29443,15,,,
31265,23020,8245,10,,,
32097,5493,26604,13,,,
34142,20334,13808,29,,,
27409,25832,1577,13,,,
33802,30102,3700,14,,,
33839,3648,30191,21,,,
29727,19147,10580,28,,,
29702,6706,22996,11,,,
23631,21205,2426,12,,,
33708,32876,832,9,,,
19516,3833,15683,10,,,
30036,28148,1888,23,,,
25288,8122,17166,24,,,
25916,1220,24696,15,,,
29953,15927,14026,14,,,
27913,7821,20092,17,,,
27759,467,27292,27,,,
27828,25484,2344,14,,,
24104,19038,5066,13,,,
27772,21180,6592,22,,,
31706,27005,4701,13,,,
31592,20604,10988,20,,,
28144,11163,16981,26,,,
27534,23483,4051,10,,,
35405,4467,30938,17,,,
33563,18621,14942,6,,,
29149,17590,11559,19,,,
28112,18137,9975,13,,,
29740,7960,21780,4,,,
27232,18372,8860,8,,,
25870,24256,1614,11,,,
29469,21508,7961,7,,,
31941,2707,29234,9,,,
30095,20278,9817,10,,,
29882,12101,17781,9,,,
27300,11299,16001,15,,,
31155,11106,20049,19,,,
39073,22528,16545,12,,,
27422,3296,24126,11,,,
29083,26850,2233,11,,,
31284,23059,8225,7,,,
25947,5230,20717,14,,,
33141,8373,24768,5,,,
27616,14919,12697,23,,,
33239,10327,22912,9,,,
27229,18482,8747,6,,,
29654,22783,6871,17,,,
36013,32048,3965,17,,,
31874,11160,20714,19,,,
33388,21978,11410,13,,,
25781,9462,16319,14,,,
23746,15224,8522,12,,,
23711,4621,19090,7,,,
29388,18766,10622,9,,,
26219,2625,23594,8,,,
35557,4267,31290,6,,,
26808,17789,9019,11,,,
30210,15944,14266,16,,,
21699,18510,3189,8,,,
29387,10978,18409,16,,,
29581,3544,26037,13,,,
29147,6338,22809,20,,,
29556,15859,13697,10,,,
33171,17932,15239,6,,,
33413,25905,7508,11,,,
32996,16408,16588,14,,,
33689,20638,13051,16,,,
35873,8039,27834,12,,,
27654,2747,24907,7,,,
37817,20540,17277,11,,,
25536,4623,20913,14,,,
24789,10115,14674,10,,,
25383,13559,11824,10,,,
23733,22838,895,20,,,
29272,15841,13431,5,,,
32972,18066,14906,14,,,
31139,16058,15081,10,,,
33589,12191,21398,13,,,
33379,26846,6533,13,,,
28198,25995,2203,11,,,
33231,1027,32204,10,,,
28109,20474,7635,19,,,
25782,22882,2900,18,,,
29358,18319,11039,11,,,
27712,20219,7493,13,,,
21335,20978,357,13,,,
25250,14747,10503,23,,,
31762,7882,23880,14,,,
35655,21291,14364,32,,,
37770,24313,13457,13,,,
33135,18101,15034,23,,,
33837,28977,4860,7,,,
31449,26056,5393,11,,,
28122,8786,19336,6,,,
27526,12623,14903,18,,,
29017,23870,5147,20,,,
30028,29166,862,16,,,
27296,5778,21518,11,,,
27365,11762,15603,12,,,
27279,18901,8378,9,,,
25291,16650,8641,17,,,
29548,17157,12391,15,,,
33415,2142,31273,13,,,
29423,27497,1926,8,,,
25000,12681,12319,13,,,
21335,7872,13463,9,,,
30083,4325,25758,15,,,
29177,7462,21715,10,,,
27914,12799,15115,15,,,
25702,21075,4627,10,,,
31707,4948,26759,19,,,
26636,14541,12095,22,,,
29630,171,29459,20,,,
29051,24248,4803,15,,,
26850,4377,22473,18,,,
31454,10542,20912,8,,,
33125,12250,20875,8,,,
29121,2944,26177,10,,,
31070,29133,1937,29,,,
29907,16379,13528,9,,,
21352,21208,144,8,,,
29055,19488,9567,8,,,
29651,25236,4415,5,,,
39118,24504,14614,12,,,
23851,11278,12573,12,,,
23707,16619,7088,10,,,
35513,9600,25913,18,,,
36939,35085,1854,8,,,
29494,70,29424,17,,,
29213,25052,4161,15,,,
31392,15440,15952,16,,,
23657,21703,1954,23,,,
29556,13560,15996,15,,,
31074,8885,22189,18,,,
25207,12155,13052,5,,,
29422,28041,1381,10,,,
33659,15524,18135,15,,,
26426,15455,10971,23,,,
33682,12967,20715,11,,,
30777,6856,23921,14,,,
29525,9866,19659,9,,,
32273,15745,16528,12,,,
30888,6735,24153,12,,,
34997,20474,14523,10,,,
27183,2779,24404,19,,,
33916,32184,1732,4,,,
31926,23651,8275,15,,,
33654,13170,20484,11,,,
29712,23697,6015,12,,,
25136,15205,9931,16,,,
28055,7833,20222,12,,,
33006,25840,7166,11,,,
23904,16657,7247,16,,,
26842,8947,17895,9,,,
27629,6176,21453,14,,,
29807,11750,18057,15,,,
29330,5332,23998,9,,,
27319,14098,13221,16,,,
33842,23028,10814,6,,,
28839,8584,20255,25,,,
23715,3887,19828,15,,,
35814,5040,30774,7,,,
31839,6184,25655,17,,,
31610,25554,6056,24,,,
15308,13011,2297,10,,,
17822,7433,10389,11,,,
17779,12822,4957,14,,,
35893,17051,18842,20,,,
27973,22867,5106,11,,,
33587,19583,14004,9,,,
33510,5917,27593,17,,,
35404,15463,19941,10,,,
21981,7568,14413,15,,,
15553,11743,3810,11,,,
30710,2577,28133,10,,,
31169,21006,10163,28,,,
29624,27023,2601,9,,,
29302,27419,1883,11,,,
31475,11822,19653,8,,,
25743,12836,12907,7,,,
27795,1731,26064,14,,,
25698,6597,19101,18,,,
23509,7266,16243,14,,,
29371,26959,2412,16,,,
29914,6159,23755,16,,,
31378,20191,11187,20,,,
30098,19260,10838,9,,,
27228,14041,13187,14,,,
27155,2922,24233,18,,,
29179,21852,7327,18,,,
31759,10094,21665,9,,,
31576,24079,7497,14,,,
29365,9706,19659,16,,,
23320,20701,2619,14,,,
33235,31729,1506,12,,,
28959,6235,22724,17,,,
33048,29960,3088,14,,,
27990,10317,17673,20,,,
33291,13376,19915,17,,,
38545,30241,8304,13,,,
27746,22651,5095,15,,,
25841,22374,3467,11,,,
32467,14472,17995,10,,,
35539,29159,6380,14,,,
23853,14401,9452,16,,,
28909,12147,16762,12,,,
25608,25485,123,9,,,
28967,24101,4866,9,,,
23873,6227,17646,20,,,
34126,17478,16648,16,,,
39460,11703,27757,15,,,
29584,21890,7694,6,,,
26880,26651,229,8,,,
31325,26352,4973,15,,,
29436,28788,648,10,,,
37816,36522,1294,4,,,
25281,25060,221,14,,,
32046,1101,30945,12,,,
37791,34465,3326,8,,,
25304,14336,10968,15,,,
27477,23607,3870,13,,,
29916,6222,23694,10,,,
28016,1475,26541,9,,,
33934,28987,4947,20,,,
26028,9505,16523,19,,,
37368,29529,7839,14,,,
33458,19811,13647,18,,,
35796,29026,6770,16,,,
29923,16449,13474,11,,,
27252,19448,7804,5,,,
30096,16719,13377,11,,,
35194,28109,7085,9,,,
37494,3625,33869,7,,,
27757,6148,21609,14,,,
29836,7459,22377,20,,,
27174,1460,25714,11,,,
33912,5124,28788,10,,,
29564,24622,4942,18,,,
29676,8759,20917,6,,,
25563,1416,24147,13,,,
28752,13792,14960,12,,,
34134,17539,16595,9,,,
31639,18617,13022,8,,,
29592,18173,11419,17,,,
34374,27197,7177,9,,,
32168,17914,14254,11,,,
29917,13104,16813,5,,,
27854,10326,17528,14,,,
27420,9093,18327,17,,,
31187,28047,3140,11,,,
29012,14392,14620,14,,,
25815,641,25174,6,,,
31441,30957,484,19,,,
31095,18154,12941,17,,,
31989,21085,10904,5,,,
24932,7432,17500,10,,,
25488,15309,10179,16,,,
33191,24599,8592,24,,,
27241,25502,1739,10,,,
27568,27025,543,9,,,
37283,30761,6522,11,,,
40122,4216,35906,6,,,
25914,22329,3585,15,,,
21277,5828,15449,15,,,
25629,20893,4736,19,,,
23843,8184,15659,9,,,
22855,18203,4652,7,,,
25216,22196,3020,6,,,
31727,12424,19303,16,,,
31548,21208,10340,27,,,
29996,14812,15184,27,,,
32402,988,31414,21,,,
24883,1629,23254,10,,,
29459,24696,4763,20,,,
35659,25550,10109,15,,,
33653,2390,31263,16,,,
28027,27567,460,21,,,
27847,13742,14105,14,,,
22908,21237,1671,14,,,
35571,7863,27708,14,,,
29841,26547,3294,13,,,
27817,5320,22497,15,,,
29575,1765,27810,17,,,
21937,17178,4759,10,,,
28880,27419,1461,10,,,
31161,18197,12964,18,,,
25924,14043,11881,14,,,
28033,15599,12434,13,,,
29163,13027,16136,13,,,
30387,24153,6234,7,,,
33384,17272,16112,8,,,
29609,20178,9431,10,,,
33895,29814,4081,11,,,
24023,10666,13357,21,,,
34269,12652,21617,15,,,
23383,15842,7541,13,,,
30342,10564,19778,12,,,
27632,19018,8614,12,,,
29083,28604,479,14,,,
29310,5287,24023,16,,,
27796,3693,24103,25,,,
23552,6038,17514,20,,,
28748,27812,936,16,,,
32337,29306,3031,12,,,
31100,2283,28817,8,,,
34069,23091,10978,14,,,
19711,1914,17797,25,,,
25478,12240,13238,11,,,
23911,16398,7513,14,,,
35750,4181,31569,13,,,
29429,278,29151,18,,,
35771,20948,14823,12,,,
26293,8324,17969,15,,,
27512,2638,24874,7,,,
31996,9398,22598,13,,,
29388,16807,12581,14,,,
29346,21132,8214,20,,,
33623,31155,2468,19,,,
31697,28232,3465,18,,,
25868,21587,4281,23,,,
29400,3445,25955,13,,,
25912,4795,21117,10,,,
36347,19519,16828,10,,,
29823,24278,5545,13,,,
22179,13401,8778,9,,,
29635,17705,11930,15,,,
35605,7699,27906,10,,,
37311,24950,12361,7,,,
33240,26416,6824,11,,,
23851,19940,3911,13,,,
31923,20056,11867,14,,,
25636,15375,10261,8,,,
28032,3555,24477,14,,,
23416,22330,1086,13,,,
29925,22410,7515,15,,,
29378,14395,14983,10,,,
28149,16693,11456,11,,,
29160,14929,14231,19,,,
33309,32529,780,10,,,
27713,7142,20571,13,,,
28003,2240,25763,14,,,
21976,7461,14515,10,,,
33859,27369,6490,16,,,
26005,14603,11402,12,,,
33679,26224,7455,14,,,
29618,14645,14973,15,,,
33926,12682,21244,12,,,
25654,21366,4288,26,,,
23811,22343,1468,19,,,
23869,1338,22531,10,,,
23691,9369,14322,14,,,
31846,29490,2356,10,,,
31735,20720,11015,16,,,
23840,5600,18240,8,,,
28941,9207,19734,16,,,
27806,19902,7904,22,,,
27495,3403,24092,18,,,
21367,10281,11086,14,,,
33397,19711,13686,16,,,
30928,45,30883,12,,,
30616,16432,14184,23,,,
29257,15364,13893,16,,,
29725,24915,4810,15,,,
27933,14070,13863,29,,,
34088,8169,25919,10,,,
29395,22654,6741,7,,,
29312,10665,18647,8,,,
31808,17492,14316,13,,,
35881,25612,10269,13,,,
31504,16581,14923,12,,,
36969,664,36305,8,,,
31946,9089,22857,9,,,
21606,5623,15983,11,,,
35467,8699,26768,8,,,
30509,7366,23143,26,,,
23582,10920,12662,20,,,
27512,8732,18780,9,,,
21604,17028,4576,26,,,
35534,22408,13126,10,,,
26140,2813,23327,10,,,
27311,21961,5350,6,,,
25847,6744,19103,14,,,
35020,16525,18495,20,,,
27906,5245,22661,13,,,
33205,26154,7051,13,,,
31581,9666,21915,10,,,
19803,2427,17376,9,,,
36035,33282,2753,17,,,
24153,9578,14575,16,,,
25724,14643,11081,9,,,
32592,8400,24192,5,,,
33793,21721,12072,13,,,
25589,1560,24029,19,,,
29158,8611,20547,6,,,
25826,2946,22880,15,,,
27848,25525,2323,9,,,
27213,15364,11849,15,,,
37345,18577,18768,13,,,
27228,17725,9503,5,,,
29024,6757,22267,9,,,
33641,11103,22538,7,,,
21790,16770,5020,12,,,
25486,15518,9968,12,,,
29441,19448,9993,18,,,
30097,14739,15358,19,,,
31934,27395,4539,19,,,
27613,1072,26541,18,,,
32970,14011,18959,12,,,
28244,12498,15746,12,,,
37930,26081,11849,11,,,
23138,3723,19415,5,,,
29951,29278,673,18,,,
31937,31433,504,23,,,
33576,10578,22998,14,,,
31219,25573,5646,32,,,
35296,22280,13016,11,,,
33627,18395,15232,17,,,
33331,31042,2289,6,,,
26125,13005,13120,19,,,
29427,14633,14794,12,,,
29934,4241,25693,9,,,
26023,20862,5161,8,,,
33877,23567,10310,13,,,
24263,14540,9723,19,,,
29747,7372,22375,8,,,
26956,3216,23740,12,,,
31435,12864,18571,15,,,
31083,9327,21756,15,,,
34104,4855,29249,12,,,
34294,7396,26898,11,,,
24813,24356,457,8,,,
26953,1799,25154,8,,,
29931,1116,28815,11,,,
29446,21098,8348,24,,,
35334,17142,18192,7,,,
29293,6030,23263,10,,,
32588,8224,24364,14,,,
29784,5246,24538,6,,,
29038,13431,15607,7,,,
30957,14028,16929,15,,,
33338,25183,8155,5,,,
25968,9192,16776,13,,,
29834,27416,2418,7,,,
23552,2067,21485,17,,,
27483,16831,10652,9,,,
30977,9499,21478,15,,,
27512,9322,18190,6,,,
29068,6171,22897,21,,,
26668,5003,21665,3,,,
24997,4018,20979,10,,,
37501,28057,9444,8,,,
28979,12022,16957,11,,,
31338,11368,19970,13,,,
32255,14611,17644,10,,,
25754,19198,6556,20,,,
31684,9555,22129,13,,,
26665,13690,12975,21,,,
27272,8090,19182,15,,,
29231,15954,13277,26,,,
23700,6963,16737,17,,,
29734,12312,17422,18,,,
31466,14832,16634,9,,,
22350,5242,17108,21,,,
24981,6944,18037,18,,,
35479,34070,1409,24,,,
25195,12916,12279,8,,,
25882,18808,7074,19,,,
29743,27247,2496,14,,,
27229,16514,10715,15,,,
27583,3607,23976,11,,,
23620,6573,17047,17,,,
35766,2793,32973,6,,,
33448,15921,17527,20,,,
25531,8710,16821,12,,,
20021,8778,11243,18,,,
31451,18658,12793,15,,,
27822,23169,4653,17,,,
33892,32555,1337,21,,,
27098,4527,22571,22,,,
35720,28792,6928,15,,,
30185,7632,22553,13,,,
23247,18754,4493,11,,,
25657,12985,12672,18,,,
26029,15073,10956,4,,,
29975,10435,19540,12,,,
34875,26701,8174,9,,,
25805,3164,22641,15,,,
31698,17597,14101,11,,,
27529,1090,26439,14,,,
33883,49,33834,11,,,
30763,18875,11888,20,,,
29539,5445,24094,21,,,
32052,28567,3485,14,,,
25328,25293,35,18,,,
29566,16700,12866,12,,,
31708,10179,21529,23,,,
25737,2315,23422,11,,,
36982,18419,18563,17,,,
35589,21134,14455,7,,,
30696,13657,17039,7,,,
27898,12250,15648,14,,,
29821,8155,21666,9,,,
33732,1890,31842,5,,,
27698,18210,9488,6,,,
23324,937,22387,9,,,
21775,17018,4757,20,,,
33689,15355,18334,12,,,
30003,3001,27002,15,,,
31291,25114,6177,5,,,
35561,15957,19604,18,,,
35312,6803,28509,11,,,
21830,18136,3694,12,,,
31471,19739,11732,6,,,
25330,18123,7207,15,,,
25293,23127,2166,18,,,
25490,23919,1571,12,,,
37923,36823,1100,8,,,
26133,1732,24401,18,,,
27092,17525,9567,8,,,
27353,9581,17772,13,,,
26088,18276,7812,20,,,
28187,4752,23435,12,,,
27248,1900,25348,18,,,
24984,16002,8982,10,,,
27435,26933,502,8,,,
29817,12174,17643,13,,,
29908,15331,14577,21,,,
31385,19090,12295,11,,,
28007,1358,26649,7,,,
29295,10459,18836,15,,,
22900,7375,15525,5,,,
27222,18379,8843,18,,,
23592,20851,2741,17,,,
19572,1022,18550,26,,,
30970,29955,1015,9,,,
34085,31345,2740,9,,,
31434,4149,27285,12,,,
29575,13931,15644,15,,,
36068,16012,20056,15,,,
24771,12328,12443,9,,,
29671,27825,1846,13,,,
22217,5328,16889,9,,,
27875,23914,3961,9,,,
27437,8134,19303,23,,,
23340,3513,19827,16,,,
31575,20884,10691,10,,,
23470,16993,6477,10,,,
31112,7490,23622,10,,,
33479,3753,29726,14,,,
28721,8862,19859,13,,,
27729,6712,21017,22,,,
34948,26263,8685,11,,,
27132,17786,9346,9,,,
27164,19698,7466,14,,,
38127,19738,18389,16,,,
29983,28238,1745,6,,,
31739,14185,17554,12,,,
29426,3548,25878,22,,,
23655,3557,20098,22,,,
37413,27326,10087,11,,,
25800,8693,17107,10,,,
30240,9961,20279,9,,,
33080,17250,15830,9,,,
23777,1624,22153,12,,,
27718,21086,6632,10,,,
31661,14461,17200,14,,,
31324,14637,16687,9,,,
31447,4649,26798,17,,,
29415,1628,27787,15,,,
28997,8338,20659,8,,,
31731,18265,13466,18,,,
30066,14935,15131,11,,,
37594,36897,697,12,,,
30791,8396,22395,12,,,
33809,24962,8847,16,,,
29445,28374,1071,15,,,
31859,9301,22558,9,,,
27578,11688,15890,11,,,
29245,9944,19301,4,,,
23242,20152,3090,14,,,
30255,3302,26953,10,,,
31540,18819,12721,9,,,
30739,25960,4779,15,,,
22262,16661,5601,10,,,
24138,16433,7705,6,,,
29844,372,29472,16,,,
27109,544,26565,13,,,
29301,24133,5168,13,,,
36413,14681,21732,23,,,
29676,652,29024,10,,,
29588,18718,10870,11,,,
27506,968,26538,6,,,
28095,6410,21685,14,,,
27620,24356,3264,11,,,
27909,11033,16876,11,,,
27333,5238,22095,21,,,
28950,6925,22025,11,,,
33272,20413,12859,10,,,
35798,19352,16446,12,,,
27218,15310,11908,10,,,
31768,11409,20359,9,,,
31308,21633,9675,17,,,
27193,7570,19623,8,,,
32986,7579,25407,10,,,
31891,19700,12191,12,,,
29754,5573,24181,7,,,
30053,17199,12854,31,,,
25746,3186,22560,19,,,
33658,32541,1117,11,,,
39733,36593,3140,17,,,
29383,20743,8640,16,,,
35530,8426,27104,24,,,
29886,9212,20674,11,,,
31694,13815,17879,12,,,
27237,20262,6975,6,,,
39457,30202,9255,10,,,
25401,10397,15004,5,,,
35601,5786,29815,11,,,
34748,20103,14645,26,,,
29999,10222,19777,19,,,
29807,20199,9608,15,,,
29224,16079,13145,9,,,
31156,12167,18989,12,,,
30929,9179,21750,12,,,
33564,8046,25518,9,,,
29371,28406,965,10,,,
27339,2875,24464,22,,,
29838,24595,5243,14,,,
29884,22731,7153,10,,,
31060,25183,5877,12,,,
27481,4509,22972,16,,,
29733,2246,27487,9,,,
33553,21517,12036,8,,,
31668,14135,17533,16,,,
30100,15889,14211,10,,,
23775,10362,13413,29,,,
23528,4228,19300,18,,,
37341,26135,11206,22,,,
29078,18869,10209,18,,,
28168,14974,13194,9,,,
27243,7494,19749,16,,,
27548,11923,15625,19,,,
27080,26435,645,13,,,
29885,11821,18064,11,,,
36096,35022,1074,10,,,
34021,245,33776,19,,,
25934,2894,23040,17,,,
29840,26918,2922,24,,,
29886,3498,26388,11,,,
31273,13646,17627,9,,,
27460,21302,6158,22,,,
21699,12756,8943,9,,,
31692,3094,28598,19,,,
32006,3380,28626,10,,,
27630,15164,12466,10,,,
27919,10293,17626,15,,,
30920,25233,5687,11,,,
30033,7072,22961,9,,,
32063,16155,15908,16,,,
34253,9897,24356,16,,,
32067,20234,11833,17,,,
25518,4066,21452,19,,,
26146,24205,1941,10,,,
25652,900,24752,24,,,
40774,32561,8213,19,,,
30849,13379,17470,17,,,
31953,10137,21816,14,,,
29683,2538,27145,10,,,
29363,5355,24008,12,,,
23840,9911,13929,24,,,
27647,11882,15765,17,,,
25379,3405,21974,17,,,
29153,9738,19415,11,,,
33602,6315,27287,9,,,
29960,11008,18952,10,,,
29630,20272,9358,17,,,
29858,14401,15457,19,,,
29919,14297,15622,12,,,
25994,15470,10524,14,,,
35779,994,34785,12,,,
27288,12288,15000,17,,,
35499,19291,16208,13,,,
27680,25746,1934,11,,,
31587,22362,9225,6,,,
31237,11102,20135,11,,,
35646,11414,24232,19,,,
25291,4242,21049,11,,,
22071,17517,4554,32,,,
25157,4823,20334,15,,,
19754,2048,17706,10,,,
21967,17606,4361,3,,,
39418,5221,34197,4,,,
25617,10583,15034,16,,,
29607,24826,4781,15,,,
29817,10175,19642,16,,,
33407,11993,21414,13,,,
25656,6930,18726,17,,,
29748,25670,4078,5,,,
29886,21023,8863,14,,,
23232,20027,3205,16,,,
35599,13335,22264,26,,,
33634,27516,6118,9,,,
29721,3292,26429,14,,,
35828,8520,27308,11,,,
27818,8474,19344,14,,,
29046,19724,9322,13,,,
32244,11237,21007,5,,,
29522,9698,19824,12,,,
25753,18904,6849,22,,,
29412,20200,9212,12,,,
33461,11042,22419,14,,,
25027,23772,1255,6,,,
27901,1144,26757,14,,,
29615,6178,23437,15,,,
31440,23614,7826,6,,,
29493,20083,9410,10,,,
29689,24575,5114,15,,,
27923,23130,4793,26,,,
29343,27720,1623,19,,,
25675,13350,12325,12,,,
31630,25215,6415,22,,,
25892,17123,8769,12,,,
27273,5264,22009,4,,,
26585,15053,11532,18,,,
27545,21955,5590,16,,,
28185,22779,5406,7,,,
19309,13298,6011,19,,,
26453,6691,19762,22,,,
23366,14424,8942,7,,,
34760,7926,26834,10,,,
25745,13707,12038,7,,,
35347,1375,33972,7,,,
25805,22442,3363,12,,,
32365,28914,3451,10,,,
21432,12923,8509,18,,,
27778,4354,23424,6,,,
21412,11855,9557,9,,,
33790,29784,4006,21,,,
25562,11505,14057,7,,,
31254,12415,18839,21,,,
35610,20229,15381,8,,,
35491,11290,24201,9,,,
36095,2719,33376,10,,,
23159,8592,14567,15,,,
35526,31281,4245,14,,,
25360,17292,8068,20,,,
29260,26501,2759,17,,,
35823,24806,11017,16,,,
35873,7859,28014,15,,,
31375,14491,16884,7,,,
29874,23538,6336,7,,,
27664,7580,20084,8,,,
26282,20547,5735,23,,,
28886,20210,8676,21,,,
25323,15080,10243,13,,,
33576,12147,21429,15,,,
31170,14363,16807,19,,,
31214,379,30835,11,,,
35711,32198,3513,8,,,
32082,19361,12721,13,,,
31679,30669,1010,8,,,
23571,14420,9151,28,,,
25960,14736,11224,9,,,
29526,12289,17237,26,,,
27569,15391,12178,9,,,
27432,8151,19281,11,,,
29302,3556,25746,12,,,
19794,13321,6473,16,,,
25419,12797,12622,17,,,
23413,5266,18147,14,,,
28912,9248,19664,10,,,
31624,22191,9433,9,,,
27334,24780,2554,14,,,
27673,24591,3082,21,,,
35386,21708,13678,11,,,
23878,3817,20061,6,,,
32327,31055,1272,12,,,
33926,16244,17682,23,,,
27438,8044,19394,18,,,
27581,3908,23673,10,,,
31936,10563,21373,16,,,
29329,18777,10552,16,,,
33066,29373,3693,9,,,
27199,25581,1618,9,,,
37743,35852,1891,10,,,
30073,10043,20030,18,,,
23527,17959,5568,12,,,
33864,9043,24821,17,,,
25813,22536,3277,15,,,
28225,23763,4462,10,,,
29454,12150,17304,13,,,
33899,30593,3306,15,,,
37901,31298,6603,9,,,
32692,15638,17054,13,,,
30199,4645,25554,10,,,
25268,11145,14123,8,,,
29726,8848,20878,6,,,
29428,6858,22570,14,,,
31173,372,30801,14,,,
21958,3904,18054,14,,,
29309,8292,21017,9,,,
29873,3032,26841,11,,,
25680,25107,573,10,,,
27629,16925,10704,13,,,
23840,13901,9939,26,,,
27737,21842,5895,12,,,
28914,9634,19280,18,,,
34310,24601,9709,11,,,
29290,12297,16993,15,,,
28402,24384,4018,21,,,
35427,664,34763,20,,,
25493,5774,19719,14,,,
27272,11397,15875,19,,,
25781,5440,20341,12,,,
31591,6820,24771,10,,,
31104,28744,2360,10,,,
25267,3623,21644,9,,,
35506,18000,17506,21,,,
25131,13401,11730,9,,,
27951,18928,9023,8,,,
35288,7253,28035,8,,,
32908,8802,24106,10,,,
35656,8819,26837,14,,,
32035,9507,22528,14,,,
28964,4577,24387,12,,,
31606,4896,26710,20,,,
29372,6150,23222,6,,,
29915,18199,11716,11,,,
25618,4038,21580,13,,,
29303,9018,20285,17,,,
29276,25918,3358,9,,,
23313,15804,7509,19,,,
31658,14182,17476,15,,,
26995,8696,18299,11,,,
34217,3789,30428,17,,,
25639,19589,6050,14,,,
31672,13376,18296,20,,,
26213,8216,17997,8,,,
29823,7184,22639,20,,,
33926,22922,11004,13,,,
21148,5048,16100,21,,,
25313,8479,16834,12,,,
27417,19272,8145,17,,,
25790,988,24802,16,,,
29369,987,28382,11,,,
27600,26216,1384,15,,,
33076,27268,5808,19,,,
33521,15508,18013,7,,,
30119,29050,1069,20,,,
29277,28964,313,14,,,
24438,16238,8200,20,,,
31333,29222,2111,15,,,
27124,4598,22526,11,,,
31912,16194,15718,7,,,
30891,15802,15089,7,,,
35560,19391,16169,15,,,
29892,28346,1546,10,,,
27360,24174,3186,16,,,
31765,19090,12675,12,,,
32043,13546,18497,19,,,
33043,15814,17229,11,,,
33205,19982,13223,6,,,
25191,18314,6877,17,,,
31296,14310,16986,4,,,
28150,10510,17640,9,,,
29807,27484,2323,12,,,
34843,29045,5798,5,,,
25857,629,25228,15,,,
27410,9637,17773,14,,,
24945,17890,7055,6,,,
31623,10356,21267,20,,,
27139,5317,21822,16,,,
29611,5615,23996,19,,,
27546,22754,4792,15,,,
31550,11453,20097,17,,,
37956,32721,5235,14,,,
36025,22487,13538,15,,,
32893,12311,20582,12,,,
31289,25728,5561,17,,,
22159,18378,3781,8,,,
29665,16585,13080,12,,,
25260,12383,12877,10,,,
33231,32942,289,15,,,
31355,3566,27789,8,,,
37680,23870,13810,18,,,
29555,6800,22755,11,,,
27997,18066,9931,15,,,
27688,3044,24644,5,,,
33495,11231,22264,20,,,
31684,20769,10915,18,,,
35096,25950,9146,11,,,
29858,16017,13841,14,,,
28118,19140,8978,18,,,
29764,10391,19373,10,,,
26320,6151,20169,9,,,
27623,21761,5862,12,,,
21379,31,21348,10,,,
23934,23102,832,9,,,
27799,5528,22271,17,,,
29219,16369,12850,15,,,
31565,29579,1986,17,,,
35610,26704,8906,17,,,
29552,12052,17500,12,,,
34843,11671,23172,14,,,
37087,28876,8211,10,,,
27878,11800,16078,15,,,
33216,5303,27913,12,,,
33571,30735,2836,10,,,
31781,6055,25726,18,,,
28660,3647,25013,12,,,
29144,20308,8836,13,,,
31617,26173,5444,7,,,
30293,7197,23096,11,,,
31618,12372,19246,25,,,
23555,21283,2272,6,,,
27624,2256,25368,16,,,
25699,6909,18790,20,,,
26061,9505,16556,16,,,
34873,2171,32702,17,,,
33417,9318,24099,14,,,
33772,32984,788,23,,,
31599,15373,16226,13,,,
25213,5026,20187,16,,,
37225,3394,33831,5,,,
29604,6807,22797,8,,,
28826,27278,1548,12,,,
29390,18100,11290,4,,,
27855,8691,19164,9,,,
31740,20073,11667,12,,,
37670,2625,35045,15,,,
33906,2926,30980,8,,,
30918,2600,28318,16,,,
29802,12444,17358,10,,,
29506,14998,14508,16,,,
23826,6300,17526,6,,,
31644,19419,12225,14,,,
29274,26384,2890,19,,,
33844,2951,30893,20,,,
23805,18,23787,9,,,
31833,8227,23606,16,,,
31166,7803,23363,6,,,
25318,13143,12175,17,,,
32609,32080,529,11,,,
31777,27206,4571,15,,,
22390,8428,13962,16,,,
29763,11401,18362,17,,,
32119,24871,7248,30,,,
27415,9273,18142,9,,,
29882,9391,20491,6,,,
22098,2275,19823,20,,,
33964,29182,4782,5,,,
24332,13277,11055,8,,,
31691,9070,22621,17,,,
27891,8356,19535,11,,,
35479,7937,27542,16,,,
33921,28338,5583,6,,,
29405,893,28512,15,,,
33473,598,32875,17,,,
31619,10361,21258,17,,,
32925,20876,12049,19,,,
30108,20948,9160,12,,,
25419,3521,21898,12,,,
31807,19602,12205,5,,,
36273,7981,28292,12,,,
33752,3345,30407,6,,,
33164,1222,31942,14,,,
29988,17955,12033,9,,,
27554,21622,5932,18,,,
31581,24849,6732,13,,,
32049,30335,1714,17,,,
23935,14740,9195,8,,,
30040,11155,18885,18,,,
27521,13944,13577,7,,,
33104,19700,13404,17,,,
36017,5851,30166,15,,,
27315,14198,13117,13,,,
31235,20381,10854,9,,,
33727,13816,19911,9,,,
31476,20519,10957,10,,,
29532,25602,3930,16,,,
31641,5463,26178,18,,,
25371,11892,13479,11,,,
33365,17434,15931,23,,,
31603,145,31458,7,,,
20080,11492,8588,5,,,
26845,1547,25298,14,,,
29645,18365,11280,10,,,
31517,25225,6292,12,,,
30217,18459,11758,11,,,
29543,19506,10037,25,,,
29843,28910,933,5,,,
33799,5568,28231,13,,,
25720,18355,7365,19,,,
30087,28109,1978,16,,,
31598,23394,8204,18,,,
27224,10057,17167,17,,,
27627,276,27351,8,,,
32027,29370,2657,16,,,
30421,3634,26787,8,,,
29788,6665,23123,19,,,
34327,13213,21114,13,,,
35903,24973,10930,13,,,
29821,16708,13113,11,,,
25237,17310,7927,14,,,
24227,21002,3225,19,,,
28036,25841,2195,22,,,
29622,24592,5030,14,,,
26403,5334,21069,9,,,
34681,15497,19184,23,,,
21322,15377,5945,11,,,
37646,426,37220,9,,,
27519,2779,24740,8,,,
31842,20726,11116,14,,,
25821,13406,12415,11,,,
23942,17173,6769,8,,,
23431,20702,2729,12,,,
27407,5894,21513,6,,,
33548,28272,5276,5,,,
33382,24661,8721,12,,,
31947,23689,8258,13,,,
35185,33885,1300,13,,,
34969,22959,12010,12,,,
25520,21641,3879,11,,,
30446,16499,13947,18,,,
31380,11635,19745,17,,,
35327,13825,21502,13,,,
27101,914,26187,17,,,
33616,17749,15867,17,,,
33944,8141,25803,9,,,
33739,10995,22744,16,,,
33347,32669,678,9,,,
23174,5844,17330,11,,,
29246,17421,11825,8,,,
35655,29566,6089,19,,,
38066,27962,10104,19,,,
28954,13243,15711,15,,,
25861,5627,20234,8,,,
29812,6263,23549,12,,,
36129,7971,28158,11,,,
27735,7320,20415,14,,,
33139,19328,13811,8,,,
33606,26690,6916,14,,,
31141,30129,1012,7,,,
29789,21634,8155,10,,,
25343,23878,1465,25,,,
27913,8180,19733,11,,,
33017,20324,12693,16,,,
31873,25531,6342,16,,,
31630,25386,6244,22,,,
29483,6190,23293,21,,,
27338,1333,26005,7,,,
31402,19789,11613,15,,,
27391,13660,13731,11,,,
37596,7680,29916,16,,,
29331,12220,17111,10,,,
25666,16433,9233,8,,,
33599,5226,28373,13,,,
31261,11695,19566,12,,,
35569,16057,19512,8,,,
28886,15426,13460,5,,,
22983,12531,10452,18,,,
25054,19073,5981,10,,,
19848,367,19481,10,,,
25136,21704,3432,5,,,
35010,11728,23282,9,,,
19629,3036,16593,12,,,
38248,14933,23315,12,,,
31637,13823,17814,8,,,
32065,17666,14399,10,,,
28567,14762,13805,16,,,
31845,24645,7200,18,,,
31739,21035,10704,18,,,
30404,12896,17508,22,,,
32135,28481,3654,11,,,
29547,17428,12119,12,,,
34218,33982,236,13,,,
31767,16727,15040,15,,,
39190,18414,20776,15,,,
29545,22562,6983,15,,,
31776,17134,14642,7,,,
22806,5839,16967,11,,,
23200,13356,9844,11,,,
23596,19454,4142,19,,,
29760,10978,18782,13,,,
25998,23494,2504,22,,,
33191,6881,26310,11,,,
31627,5796,25831,5,,,
30057,1522,28535,15,,,
21637,16094,5543,11,,,
33484,9440,24044,19,,,
27359,18989,8370,8,,,
27306,7773,19533,19,,,
22084,20305,1779,22,,,
33795,13976,19819,7,,,
27390,2260,25130,15,,,
19786,18454,1332,14,,,
33936,23509,10427,6,,,
29343,11578,17765,11,,,
31208,11195,20013,8,,,
31566,7172,24394,16,,,
34008,32573,1435,12,,,
25641,15210,10431,15,,,
29429,27907,1522,9,,,
29840,11190,18650,14,,,
27626,8218,19408,6,,,
19255,5599,13656,15,,,
27330,25491,1839,7,,,
26991,21944,5047,9,,,
25215,247,24968,18,,,
33680,22025,11655,15,,,
31974,7086,24888,5,,,
25513,12950,12563,9,,,
29659,12938,16721,4,,,
34036,25668,8368,16,,,
29491,2754,26737,15,,,
32346,4377,27969,14,,,
31241,7824,23417,13,,,
30291,13972,16319,15,,,
33871,25890,7981,13,,,
29978,525,29453,12,,,
24276,5764,18512,6,,,
23418,2593,20825,17,,,
25076,8776,16300,15,,,
24315,3597,20718,13,,,
30968,24164,6804,7,,,
27171,8243,18928,13,,,
31238,6738,24500,8,,,
28045,22,28023,11,,,
27857,16033,11824,11,,,
28077,14270,13807,18,,,
26051,24504,1547,13,,,
31562,5722,25840,16,,,
26086,25750,336,25,,,
34089,23071,11018,14,,,
30379,16761,13618,10,,,
27203,6367,20836,10,,,
29833,23501,6332,19,,,
37858,2155,35703,8,,,
21638,21446,192,11,,,
32505,9529,22976,7,,,
29623,24056,5567,12,,,
25863,14519,11344,8,,,
35172,12315,22857,8,,,
33360,4169,29191,17,,,
31194,28960,2234,6,,,
23388,18806,4582,5,,,
31356,25839,5517,17,,,
27054,22465,4589,23,,,
28889,13527,15362,27,,,
24121,13538,10583,11,,,
35019,25912,9107,19,,,
29437,21082,8355,11,,,
25088,9142,15946,9,,,
31293,30326,967,9,,,
33680,1302,32378,16,,,
28064,7526,20538,19,,,
34756,32150,2606,15,,,
36310,17338,18972,11,,,
27571,13742,13829,10,,,
19785,13476,6309,19,,,
29866,15518,14348,18,,,
23321,9705,13616,12,,,
30721,12565,18156,24,,,
37419,18563,18856,20,,,
22812,14472,8340,23,,,
31796,14579,17217,16,,,
31637,16006,15631,20,,,
36033,32641,3392,6,,,
31619,1378,30241,15,,,
25459,4270,21189,17,,,
13635,6374,7261,13,,,
31390,12853,18537,11,,,
21441,3276,18165,21,,,
27631,3158,24473,13,,,
29577,21992,7585,10,,,
29644,15506,14138,17,,,
25816,2882,22934,17,,,
23895,3658,20237,15,,,
25617,478,25139,11,,,
31529,28300,3229,12,,,
25247,18719,6528,12,,,
27443,2476,24967,12,,,
25701,10479,15222,7,,,
33473,11019,22454,9,,,
35246,28435,6811,9,,,
36174,10330,25844,8,,,
33619,14943,18676,16,,,
32459,10108,22351,14,,,
23962,2665,21297,18,,,
31266,11953,19313,19,,,
33559,24601,8958,13,,,
31748,10629,21119,15,,,
28028,11303,16725,7,,,
34125,21589,12536,13,,,
29478,2483,26995,18,,,
36155,28118,8037,16,,,
31534,12905,18629,21,,,
30308,9287,21021,20,,,
29315,22610,6705,9,,,
29179,28545,634,26,,,
23733,18381,5352,11,,,
33799,28507,5292,16,,,
30115,22826,7289,23,,,
33566,32006,1560,11,,,
27485,10740,16745,14,,,
35425,5477,29948,7,,,
29091,20668,8423,10,,,
27489,26989,500,16,,,
27427,13454,13973,10,,,
27943,1452,26491,9,,,
23512,5394,18118,17,,,
26026,1623,24403,10,,,
22183,1087,21096,9,,,
21380,863,20517,7,,,
33080,15553,17527,31,,,
32825,2001,30824,14,,,
23698,4282,19416,14,,,
28130,6145,21985,7,,,
25498,2214,23284,12,,,
35754,32199,3555,13,,,
31536,3708,27828,13,,,
33821,6532,27289,10,,,
29637,12282,17355,10,,,
25773,20836,4937,28,,,
35676,14969,20707,23,,,
29601,22633,6968,6,,,
30980,24879,6101,13,,,
33384,27535,5849,8,,,
33356,21234,12122,14,,,
33886,10221,23665,16,,,
21686,1307,20379,16,,,
25982,17727,8255,9,,,
31530,29771,1759,18,,,
30280,13592,16688,15,,,
25829,8765,17064,9,,,
34436,72,34364,15,,,
36032,35878,154,11,,,
23915,10640,13275,14,,,
25268,21785,3483,20,,,
27150,17488,9662,9,,,
23484,2383,21101,14,,,
29325,1973,27352,18,,,
32093,3128,28965,16,,,
28325,27048,1277,18,,,
35675,4909,30766,12,,,
33674,574,33100,10,,,
34031,17653,16378,22,,,
29204,16994,12210,13,,,
35937,11599,24338,17,,,
33815,32802,1013,13,,,
29904,8952,20952,15,,,
29816,7430,22386,17,,,
31902,29271,2631,14,,,
23666,5372,18294,9,,,
25806,14614,11192,20,,,
36963,5154,31809,23,,,
29988,13334,16654,10,,,
27536,8342,19194,17,,,
33651,21188,12463,14,,,
20903,17759,3144,15,,,
33662,13898,19764,18,,,
30048,24374,5674,15,,,
24418,19162,5256,16,,,
29699,24358,5341,21,,,
29192,20743,8449,13,,,
28114,13714,14400,8,,,
25478,340,25138,14,,,
29611,19606,10005,10,,,
28394,16268,12126,19,,,
26872,4460,22412,20,,,
23236,16896,6340,15,,,
31995,3706,28289,8,,,
26208,21202,5006,13,,,
31251,5080,26171,20,,,
29311,1050,28261,17,,,
31767,1649,30118,9,,,
32044,23781,8263,10,,,
32809,18678,14131,9,,,
32275,27548,4727,13,,,
35020,32038,2982,8,,,
29517,22709,6808,5,,,
28550,7272,21278,16,,,
39594,15625,23969,12,,,
28105,26366,1739,19,,,
29741,17243,12498,19,,,
25623,16551,9072,9,,,
32197,25836,6361,15,,,
30183,23867,6316,26,,,
29354,3060,26294,16,,,
35286,19981,15305,8,,,
31806,28713,3093,14,,,
31294,5570,25724,8,,,
27478,8707,18771,15,,,
35542,28368,7174,19,,,
19171,16436,2735,21,,,
26292,24888,1404,17,,,
30171,1979,28192,12,,,
27778,2840,24938,5,,,
29473,19318,10155,9,,,
37685,3147,34538,5,,,
37758,20961,16797,12,,,
27365,10044,17321,15,,,
33276,12953,20323,11,,,
29550,20090,9460,14,,,
25443,4905,20538,8,,,
25620,3436,22184,6,,,
31167,6520,24647,21,,,
31573,17665,13908,13,,,
33872,28517,5355,9,,,
26766,17856,8910,9,,,
36968,21919,15049,36,,,
29743,26026,3717,15,,,
26771,15220,11551,20,,,
33463,29886,3577,8,,,
39901,7170,32731,20,,,
19019,10811,8208,8,,,
29811,2207,27604,10,,,
27736,6897,20839,8,,,
33955,31191,2764,11,,,
24206,11775,12431,15,,,
21957,6872,15085,20,,,
29177,26290,2887,13,,,
35263,9069,26194,31,,,
30478,12534,17944,21,,,
23910,6952,16958,17,,,
33756,19314,14442,10,,,
30937,22705,8232,24,,,
32024,17822,14202,13,,,
27433,7102,20331,12,,,
29902,11318,18584,22,,,
33256,8590,24666,5,,,
22066,13826,8240,21,,,
23849,6157,17692,12,,,
36918,9807,27111,8,,,
28207,16736,11471,7,,,
33827,28614,5213,11,,,
27637,5163,22474,18,,,
27909,3195,24714,18,,,
27732,10650,17082,20,,,
29422,28205,1217,18,,,
31962,9373,22589,13,,,
25036,23896,1140,19,,,
37589,12987,24602,24,,,
35957,27528,8429,11,,,
23976,15159,8817,15,,,
37558,29547,8011,13,,,
31691,319,31372,12,,,
23468,19954,3514,21,,,
37735,31339,6396,12,,,
39724,25166,14558,4,,,
24138,21127,3011,17,,,
28990,3701,25289,7,,,
27653,26847,806,11,,,
33875,16549,17326,17,,,
33453,18263,15190,19,,,
31532,22874,8658,13,,,
24793,8342,16451,10,,,
24994,5145,19849,8,,,
41974,4395,37579,15,,,
28814,3440,25374,12,,,
27764,24455,3309,11,,,
34842,29238,5604,15,,,
34330,6869,27461,23,,,
36041,35545,496,11,,,
33304,6733,26571,18,,,
30173,3933,26240,21,,,
31778,28860,2918,6,,,
29525,18212,11313,13,,,
31562,17948,13614,13,,,
31675,26018,5657,9,,,
31479,24911,6568,9,,,
26633,22783,3850,13,,,
33957,32644,1313,8,,,
27884,15982,11902,23,,,
30702,643,30059,10,,,
36032,28297,7735,15,,,
31595,30825,770,11,,,
35213,19080,16133,8,,,
30332,23669,6663,10,,,
23288,14231,9057,17,,,
27815,14276,13539,14,,,
32037,25703,6334,21,,,
37923,3740,34183,18,,,
36690,15660,21030,8,,,
29896,27288,2608,14,,,
31146,20029,11117,12,,,
34261,6065,28196,17,,,
26164,21063,5101,6,,,
29452,16168,13284,9,,,
31733,2374,29359,18,,,
25565,8619,16946,16,,,
31422,18143,13279,15,,,
35914,6717,29197,11,,,
29665,7445,22220,5,,,
27770,27491,279,8,,,
34537,22133,12404,20,,,
23739,15201,8538,18,,,
35844,12061,23783,8,,,
25705,13219,12486,5,,,
24055,21205,2850,11,,,
31911,2953,28958,14,,,
21410,19270,2140,20,,,
33045,31477,1568,15,,,
34972,31457,3515,11,,,
29793,29501,292,15,,,
33696,21094,12602,23,,,
32034,11417,20617,15,,,
21503,16303,5200,7,,,
29431,583,28848,4,,,
20799,13415,7384,17,,,
32009,31569,440,15,,,
33590,25164,8426,19,,,
23260,15344,7916,15,,,
23982,8849,15133,14,,,
29509,21197,8312,8,,,
27685,11747,15938,14,,,
27696,19804,7892,10,,,
30810,17831,12979,14,,,
33820,13880,19940,15,,,
31788,1998,29790,20,,,
34147,4787,29360,7,,,
32861,5780,27081,16,,,
21668,726,20942,8,,,
22208,16798,5410,22,,,
28929,7057,21872,12,,,
25568,18727,6841,8,,,
29592,9571,20021,12,,,
33428,20742,12686,14,,,
33908,20640,13268,14,,,
24402,10229,14173,17,,,
29228,16561,12667,17,,,
24546,9763,14783,12,,,
32044,11889,20155,19,,,
31866,1677,30189,9,,,
33053,3137,29916,5,,,
31430,27458,3972,19,,,
31597,27065,4532,14,,,
35297,4554,30743,19,,,
30997,15625,15372,10,,,
33359,11499,21860,6,,,
29445,18525,10920,13,,,
27504,14109,13395,16,,,
27505,3658,23847,19,,,
27502,24489,3013,12,,,
23439,6102,17337,18,,,
31602,30180,1422,20,,,
35734,7358,28376,15,,,
31872,28664,3208,10,,,
33513,14211,19302,8,,,
26290,18757,7533,15,,,
29020,5465,23555,14,,,
31278,21851,9427,21,,,
27989,4588,23401,10,,,
25227,5739,19488,9,,,
19603,9498,10105,22,,,
29637,27849,1788,21,,,
27850,18409,9441,16,,,
31746,19406,12340,9,,,
25324,20589,4735,24,,,
33218,11697,21521,16,,,
28400,16697,11703,17,,,
32988,32468,520,14,,,
25057,7715,17342,9,,,
32090,25954,6136,10,,,
29203,691,28512,21,,,
29761,13423,16338,16,,,
29487,9924,19563,11,,,
29500,742,28758,13,,,
31936,4665,27271,13,,,
33084,24063,9021,5,,,
33154,28569,4585,17,,,
25530,7078,18452,4,,,
19372,14382,4990,15,,,
29186,11000,18186,12,,,
30071,1882,28189,10,,,
29550,14240,15310,15,,,
26049,4634,21415,8,,,
31985,28248,3737,12,,,
27686,18780,8906,11,,,
30103,13978,16125,18,,,
23801,5023,18778,7,,,
24715,13493,11222,20,,,
32048,8345,23703,4,,,
35560,5595,29965,14,,,
25055,1563,23492,13,,,
31608,23671,7937,11,,,
29923,6790,23133,13,,,
33492,9691,23801,14,,,
27178,19315,7863,20,,,
23326,20249,3077,24,,,
35431,18387,17044,21,,,
36484,3927,32557,10,,,
33005,30576,2429,11,,,
25422,11779,13643,19,,,
27263,25440,1823,20,,,
34112,10604,23508,18,,,
33968,14486,19482,11,,,
32744,15785,16959,10,,,
27382,9704,17678,19,,,
27540,24664,2876,16,,,
31858,8794,23064,13,,,
24867,16431,8436,15,,,
29147,414,28733,20,,,
36903,27930,8973,18,,,
33778,11714,22064,16,,,
29933,29188,745,11,,,
27587,22270,5317,12,,,
24244,17427,6817,21,,,
27589,479,27110,8,,,
29865,14822,15043,11,,,
25693,10013,15680,11,,,
26195,25862,333,17,,,
25227,8784,16443,19,,,
27812,15618,12194,16,,,
29599,5726,23873,11,,,
25938,12808,13130,11,,,
31693,4002,27691,14,,,
32166,19843,12323,7,,,
34587,30842,3745,20,,,
25691,4426,21265,14,,,
35654,26335,9319,12,,,
32556,3799,28757,13,,,
31987,6236,25751,16,,,
23546,3528,20018,12,,,
27783,24019,3764,11,,,
24988,18464,6524,5,,,
35214,26351,8863,18,,,
31319,27567,3752,19,,,
27406,681,26725,14,,,
27532,3200,24332,13,,,
33639,3930,29709,8,,,
31786,5663,26123,30,,,
29462,7132,22330,17,,,
29118,26357,2761,15,,,
29679,8292,21387,17,,,
29174,24246,4928,10,,,
25614,9623,15991,19,,,
25621,21244,4377,19,,,
35051,18421,16630,19,,,
27518,6624,20894,18,,,
25551,6838,18713,12,,,
38307,7440,30867,13,,,
25626,8449,17177,17,,,
33276,13420,19856,20,,,
30087,23745,6342,15,,,
29928,11222,18706,20,,,
33547,19061,14486,14,,,
31548,31067,481,20,,,
25978,3053,22925,17,,,
25545,6886,18659,19,,,
35143,3600,31543,8,,,
27756,24141,3615,12,,,
37828,27580,10248,9,,,
36031,11113,24918,8,,,
27475,10539,16936,14,,,
31688,4846,26842,16,,,
25545,22815,2730,10,,,
29431,9037,20394,5,,,
27332,2337,24995,15,,,
21739,11725,10014,17,,,
32126,2241,29885,15,,,
31620,1073,30547,16,,,
33486,2405,31081,16,,,
27303,24905,2398,15,,,
27071,536,26535,8,,,
21707,6081,15626,8,,,
25736,6167,19569,14,,,
33826,8061,25765,21,,,
31650,16545,15105,16,,,
31954,25102,6852,17,,,
30909,19534,11375,23,,,
23971,16531,7440,16,,,
27905,14124,13781,5,,,
31415,4527,26888,12,,,
23718,10238,13480,16,,,
31292,22651,8641,12,,,
29218,6207,23011,22,,,
32285,29540,2745,13,,,
31277,12520,18757,13,,,
30039,28207,1832,9,,,
37985,17252,20733,15,,,
23791,22237,1554,14,,,
29616,17320,12296,6,,,
23796,22505,1291,20,,,
29291,12562,16729,12,,,
26169,25714,455,10,,,
27240,13399,13841,25,,,
32056,14351,17705,12,,,
34796,15911,18885,5,,,
28028,24835,3193,12,,,
33233,23120,10113,18,,,
21517,15656,5861,8,,,
25747,20486,5261,8,,,
26210,8012,18198,7,,,
29173,5886,23287,15,,,
37309,249,37060,17,,,
25533,23448,2085,19,,,
23836,10653,13183,20,,,
27946,18194,9752,15,,,
31359,2767,28592,8,,,
31175,25841,5334,11,,,
28414,28269,145,21,,,
30403,20528,9875,5,,,
24340,20335,4005,10,,,
31559,28993,2566,10,,,
27545,22332,5213,10,,,
35145,5860,29285,18,,,
30257,5607,24650,14,,,
22973,14968,8005,20,,,
29563,2355,27208,10,,,
33100,11262,21838,18,,,
32266,8696,23570,17,,,
38374,11490,26884,13,,,
25657,18342,7315,8,,,
23160,19876,3284,9,,,
27366,18070,9296,14,,,
32694,5290,27404,5,,,
29094,10087,19007,15,,,
28954,8277,20677,9,,,
29914,25438,4476,11,,,
23387,9190,14197,16,,,
26973,18538,8435,11,,,
17557,6644,10913,19,,,
32206,29635,2571,10,,,
31783,12648,19135,13,,,
26925,18353,8572,9,,,
25311,6220,19091,9,,,
27388,7112,20276,16,,,
29231,18764,10467,6,,,
34059,2900,31159,8,,,
35250,31424,3826,16,,,
27725,1363,26362,18,,,
29652,11578,18074,10,,,
36985,33909,3076,23,,,
33028,18446,14582,6,,,
29282,20433,8849,16,,,
20884,14807,6077,12,,,
33270,28769,4501,18,,,
31827,4525,27302,19,,,
29315,22173,7142,6,,,
31523,17285,14238,19,,,
31696,17057,14639,15,,,
37932,1632,36300,13,,,
22184,3420,18764,19,,,
23239,6703,16536,10,,,
30823,19991,10832,14,,,
29839,18395,11444,13,,,
30101,128,29973,19,,,
35262,141,35121,17,,,
29846,28521,1325,11,,,
31317,15417,15900,11,,,
30016,15229,14787,15,,,
32415,28065,4350,12,,,
33768,6402,27366,14,,,
23923,14471,9452,11,,,
27501,1046,26455,10,,,
31303,27223,4080,7,,,
29797,28127,1670,10,,,
33039,20324,12715,8,,,
33574,24234,9340,6,,,
27111,10078,17033,6,,,
26304,7560,18744,17,,,
35824,13650,22174,14,,,
23268,15939,7329,8,,,
31770,2891,28879,24,,,
29527,14681,14846,14,,,
30984,20814,10170,9,,,
25606,20906,4700,20,,,
31204,2758,28446,12,,,
31509,9502,22007,18,,,
29310,12655,16655,12,,,
35554,2699,32855,14,,,
30564,3743,26821,15,,,
36270,33775,2495,16,,,
29264,11117,18147,6,,,
36174,31490,4684,22,,,
33737,25879,7858,19,,,
23768,8517,15251,10,,,
35256,18786,16470,8,,,
19345,15825,3520,21,,,
35556,30046,5510,9,,,
29529,22481,7048,3,,,
30203,13072,17131,11,,,
30200,16213,13987,11,,,
26923,20943,5980,11,,,
33970,2888,31082,10,,,
31924,10741,21183,5,,,
29657,27722,1935,6,,,
26660,6232,20428,9,,,
27811,27673,138,5,,,
26470,25153,1317,6,,,
29872,6859,23013,6,,,
27768,5285,22483,5,,,
25712,22401,3311,12,,,
37810,24202,13608,11,,,
29329,5006,24323,15,,,
29159,17779,11380,11,,,
33693,5440,28253,12,,,
22001,20081,1920,10,,,
27461,15405,12056,16,,,
28112,7922,20190,16,,,
29590,6591,22999,10,,,
21246,6673,14573,16,,,
33437,14841,18596,23,,,
35027,14875,20152,17,,,
27655,8263,19392,10,,,
31300,18304,12996,13,,,
35267,27330,7937,20,,,
31698,12171,19527,18,,,
38232,31429,6803,16,,,
32142,2325,29817,18,,,
29758,23076,6682,17,,,
21492,19908,1584,8,,,
37788,34380,3408,21,,,
27616,8920,18696,15,,,
25871,24671,1200,10,,,
26823,6733,20090,4,,,
30835,24141,6694,19,,,
30973,30067,906,6,,,
29606,25036,4570,19,,,
29711,10707,19004,12,,,
33799,22477,11322,9,,,
26190,5677,20513,13,,,
29222,21260,7962,11,,,
33434,7456,25978,14,,,
23826,19820,4006,14,,,
34465,7556,26909,23,,,
28210,19414,8796,10,,,
33357,24602,8755,11,,,
27623,9923,17700,12,,,
25751,22030,3721,11,,,
31934,11585,20349,8,,,
28926,15891,13035,9,,,
35984,17848,18136,12,,,
33622,7875,25747,9,,,
29934,24434,5500,11,,,
35229,20468,14761,10,,,
27061,3386,23675,9,,,
24947,5212,19735,23,,,
27775,15220,12555,18,,,
25979,18474,7505,13,,,
28027,10677,17350,10,,,
33875,28881,4994,19,,,
30776,20298,10478,13,,,
29908,24411,5497,12,,,
25716,21664,4052,5,,,
38454,27238,11216,8,,,
29889,7983,21906,15,,,
30991,23797,7194,20,,,
29299,20802,8497,23,,,
30166,29155,1011,12,,,
31698,827,30871,14,,,
27024,3543,23481,22,,,
29844,22355,7489,12,,,
25804,334,25470,10,,,
28945,10175,18770,6,,,
29112,18473,10639,6,,,
34107,31573,2534,10,,,
26984,17017,9967,21,,,
27540,4632,22908,10,,,
23722,18740,4982,11,,,
31116,882,30234,17,,,
27731,12108,15623,13,,,
31712,6397,25315,20,,,
29262,2861,26401,17,,,
35114,990,34124,10,,,
33767,29476,4291,15,,,
31541,18732,12809,14,,,
31292,19043,12249,9,,,
25444,15751,9693,8,,,
38052,5672,32380,12,,,
25358,8841,16517,13,,,
33994,27777,6217,12,,,
36588,17143,19445,12,,,
32981,30573,2408,10,,,
32174,12491,19683,8,,,
28857,5541,23316,21,,,
29098,6015,23083,21,,,
25711,15478,10233,5,,,
25531,18184,7347,8,,,
21956,14567,7389,17,,,
32205,11426,20779,9,,,
33861,10047,23814,20,,,
33810,6507,27303,15,,,
25440,1080,24360,15,,,
29918,25163,4755,17,,,
29360,10491,18869,13,,,
23072,2556,20516,23,,,
29439,27921,1518,6,,,
31429,15322,16107,23,,,
29448,26344,3104,15,,,
26209,11264,14945,13,,,
31990,10252,21738,14,,,
33254,19669,13585,10,,,
29856,27881,1975,21,,,
31250,25730,5520,8,,,
34330,15849,18481,17,,,
29476,23269,6207,13,,,
35346,24426,10920,15,,,
27846,13050,14796,6,,,
23122,15149,7973,10,,,
25748,17879,7869,10,,,
21505,1224,20281,22,,,
29196,11972,17224,8,,,
33916,10056,23860,12,,,
29472,12993,16479,13,,,
33605,25143,8462,15,,,
34143,24518,9625,20,,,
21411,21323,88,11,,,
25870,24171,1699,12,,,
29889,13408,16481,18,,,
33739,23683,10056,13,,,
34141,5228,28913,15,,,
34273,26763,7510,6,,,
31567,2571,28996,12,,,
33904,33607,297,4,,,
27119,9044,18075,10,,,
32174,26226,5948,8,,,
29593,1033,28560,22,,,
29547,26742,2805,9,,,
25777,15060,10717,20,,,
19633,631,19002,8,,,
25334,6354,18980,16,,,
29883,7592,22291,14,,,
31561,29956,1605,13,,,
29348,13561,15787,10,,,
32337,24222,8115,13,,,
33768,7942,25826,10,,,
31506,16097,15409,11,,,
26740,23845,2895,14,,,
34106,28842,5264,19,,,
